repository_name,pull_numbers,commits, changes,status,additions,deletions,filename,criticality,count_of_occurrence
shadowsocks-windows,2008,5,19,modified,19,0,shadowsocks-csharp/Controller/Logging.cs,high,0
shadowsocks-windows,2008,5,16,modified,15,1,shadowsocks-csharp/Controller/System/SystemProxy.cs,high,0
shadowsocks-windows,2008,5,2,modified,1,1,shadowsocks-csharp/Data/ja.txt,low,0
shadowsocks-windows,2008,5,3,modified,3,0,shadowsocks-csharp/Data/zh_CN.txt,low,0
shadowsocks-windows,2008,5,2,modified,1,1,shadowsocks-csharp/Data/zh_TW.txt,low,0
shadowsocks-windows,2008,5,31,modified,31,0,shadowsocks-csharp/Util/SystemProxy/ProxyException.cs,high,0
shadowsocks-windows,2008,5,81,modified,64,17,shadowsocks-csharp/Util/SystemProxy/Sysproxy.cs,high,0
shadowsocks-windows,1993,1,3,modified,3,0,shadowsocks-csharp/View/StatisticsStrategyConfigurationForm.cs,high,0
shadowsocks-windows,1986,1,0,added,0,0,shadowsocks-csharp/Data/libsscrypto64.dll.gz,NaN,1
shadowsocks-windows,1986,1,4,modified,4,0,shadowsocks-csharp/Encryption/MbedTLS.cs,high,1
shadowsocks-windows,1986,1,4,modified,4,0,shadowsocks-csharp/Encryption/Sodium.cs,high,1
shadowsocks-windows,1986,1,56,modified,33,23,shadowsocks-csharp/Properties/Resources.Designer.cs,high,1
shadowsocks-windows,1986,1,5,modified,4,1,shadowsocks-csharp/Properties/Resources.resx,medium,1
shadowsocks-windows,1986,1,2,modified,1,1,shadowsocks-csharp/Util/SystemProxy/WinINet.cs,high,1
shadowsocks-windows,1986,1,24,modified,22,2,shadowsocks-csharp/shadowsocks-csharp.csproj,low,1
shadowsocks-windows,1986,1,12,modified,11,1,shadowsocks-windows.sln,low,1
shadowsocks-windows,1986,1,14,modified,14,0,test/test.csproj,low,1
shadowsocks-windows,1978,0,713,added,713,0,test/ProcessEnvironment.cs,high,0
shadowsocks-windows,1978,0,163,modified,163,0,test/UnitTest.cs,high,0
shadowsocks-windows,1978,0,2,modified,2,0,test/test.csproj,low,1
shadowsocks-windows,1974,0,2,modified,2,0,test/test.csproj,low,2
shadowsocks-windows,1955,13,1,modified,1,0,shadowsocks-csharp/Data/zh_CN.txt,low,2
shadowsocks-windows,1955,13,6,modified,6,0,shadowsocks-csharp/View/HotkeySettingsForm.resx,medium,1
shadowsocks-windows,1955,13,1,modified,1,0,shadowsocks-csharp/shadowsocks-csharp.csproj,low,2
shadowsocks-windows,1924,5,2,modified,1,1,shadowsocks-csharp/Data/ja.txt,low,0
shadowsocks-windows,1924,5,4,modified,2,2,shadowsocks-csharp/Data/zh_CN.txt,low,2
shadowsocks-windows,1924,5,2,modified,1,1,shadowsocks-csharp/Data/zh_TW.txt,low,0
shadowsocks-windows,1924,5,38,modified,19,19,shadowsocks-csharp/View/LogForm.Designer.cs,high,0
shadowsocks-windows,1924,5,14,modified,7,7,shadowsocks-csharp/View/LogForm.cs,high,0
shadowsocks-windows,1924,5,2,modified,1,1,shadowsocks-csharp/View/LogForm.resx,medium,0
shadowsocks-windows,1892,144,2,modified,0,2,.gitignore,low,1
shadowsocks-windows,1892,144,76,modified,76,0,CHANGES,NaN,1
shadowsocks-windows,1892,144,38,modified,19,19,LICENSE.txt,low,1
shadowsocks-windows,1892,144,25,modified,16,9,README.md,low,1
shadowsocks-windows,1892,144,22,added,22,0,appveyor.yml,medium,1
shadowsocks-windows,1827,8,376,modified,122,254,shadowsocks-csharp/View/ConfigForm.resx,medium,0
shadowsocks-windows,1818,2,3,modified,2,1,shadowsocks-csharp/Data/ja.txt,low,0
shadowsocks-windows,1818,2,3,modified,2,1,shadowsocks-csharp/Data/zh_CN.txt,low,2
shadowsocks-windows,1818,2,3,modified,2,1,shadowsocks-csharp/Data/zh_TW.txt,low,0
shadowsocks-windows,1818,2,2,modified,2,0,shadowsocks-csharp/Model/Server.cs,high,0
shadowsocks-windows,1818,2,157,modified,95,62,shadowsocks-csharp/View/ConfigForm.Designer.cs,high,0
shadowsocks-windows,1818,2,5,modified,4,1,shadowsocks-csharp/View/ConfigForm.cs,high,0
shadowsocks-windows,1818,2,33,modified,30,3,shadowsocks-csharp/View/ConfigForm.resx,medium,0
shadowsocks-windows,1782,0,6,modified,3,3,shadowsocks-csharp/Data/zh_TW.txt,low,0
shadowsocks-windows,1771,0,24,modified,24,0,shadowsocks-csharp/Controller/System/Hotkeys/Hotkeys.cs,high,1
shadowsocks-windows,1753,0,2,modified,1,1,shadowsocks-csharp/Data/ja.txt,low,0
shadowsocks-windows,1753,0,2,modified,1,1,shadowsocks-csharp/Data/zh_CN.txt,low,2
shadowsocks-windows,1753,0,2,modified,1,1,shadowsocks-csharp/Data/zh_TW.txt,low,0
shadowsocks-windows,1753,0,2,modified,1,1,shadowsocks-csharp/View/MenuViewController.cs,high,0
shadowsocks-windows,1743,0,2,modified,1,1,shadowsocks-csharp/Data/ja.txt,low,1
shadowsocks-windows,1743,0,2,modified,1,1,shadowsocks-csharp/Data/zh_CN.txt,low,3
shadowsocks-windows,1743,0,2,modified,1,1,shadowsocks-csharp/Data/zh_TW.txt,low,1
shadowsocks-windows,1743,0,2,modified,1,1,shadowsocks-csharp/View/MenuViewController.cs,high,1
shadowsocks-windows,1732,1,45,modified,45,0,shadowsocks-csharp/app.config,medium,0
shadowsocks-windows,1729,1,2,modified,1,1,shadowsocks-csharp/View/MenuViewController.cs,high,1
shadowsocks-windows,1725,1,0,removed,0,0,shadowsocks-csharp/Data/libcrypto-1_1.dll.gz,NaN,0
shadowsocks-windows,1725,1,0,modified,0,0,shadowsocks-csharp/Data/libsscrypto.dll.gz,NaN,0
shadowsocks-windows,1725,1,5,modified,1,4,shadowsocks-csharp/Properties/Resources.resx,medium,1
shadowsocks-windows,1725,1,3,modified,2,1,shadowsocks-csharp/View/ConfigForm.Designer.cs,high,0
shadowsocks-windows,1725,1,1,modified,0,1,shadowsocks-csharp/shadowsocks-csharp.csproj,low,2
shadowsocks-windows,1700,0,0,removed,0,0,shadowsocks-csharp/Data/libcrypto-1_1.dll.gz,NaN,1
shadowsocks-windows,1700,0,0,modified,0,0,shadowsocks-csharp/Data/libsscrypto.dll.gz,NaN,1
shadowsocks-windows,1700,0,5,modified,1,4,shadowsocks-csharp/Properties/Resources.resx,medium,2
shadowsocks-windows,1700,0,3,modified,2,1,shadowsocks-csharp/View/ConfigForm.Designer.cs,high,1
shadowsocks-windows,1700,0,1,modified,0,1,shadowsocks-csharp/shadowsocks-csharp.csproj,low,3
shadowsocks-windows,1684,1,3,modified,2,1,shadowsocks-csharp/Controller/Service/Sip003Plugin.cs,high,2
shadowsocks-windows,1682,0,3,modified,2,1,README.md,low,1
shadowsocks-windows,1675,1,7,modified,4,3,shadowsocks-csharp/Model/Configuration.cs,high,1
shadowsocks-windows,1675,1,25,modified,25,0,shadowsocks-csharp/Util/Util.cs,high,2
shadowsocks-windows,1671,0,15,added,15,0,OPENSSL-GUIDE,NaN,0
shadowsocks-windows,1671,0,1,modified,1,0,shadowsocks-csharp/Controller/Service/Listener.cs,high,0
shadowsocks-windows,1671,0,0,added,0,0,shadowsocks-csharp/Data/libcrypto-1_1.dll.gz,NaN,1
shadowsocks-windows,1491,0,0,removed,0,0,shadowsocks-csharp/Data/abp.js.gz,NaN,1
shadowsocks-windows,1491,0,88,modified,81,7,shadowsocks-csharp/Data/cn.txt,low,1
shadowsocks-windows,1491,0,0,modified,0,0,shadowsocks-csharp/Data/libsscrypto.dll.gz,NaN,2
shadowsocks-windows,1491,0,0,added,0,0,shadowsocks-csharp/Data/mgwz.dll.gz,NaN,1
shadowsocks-windows,1491,0,0,removed,0,0,shadowsocks-csharp/Data/polipo.exe.gz,NaN,1
shadowsocks-windows,1491,0,10,removed,0,10,shadowsocks-csharp/Data/polipo_config.txt,low,1
shadowsocks-windows,1486,0,6,modified,3,3,shadowsocks-csharp/Proxy/HttpProxy.cs,high,2
shadowsocks-windows,1440,75,5,modified,5,0,.gitignore,low,3
shadowsocks-windows,1440,75,2,modified,1,1,README.md,low,4
shadowsocks-windows,1440,75,14,modified,13,1,shadowsocks-csharp.sln,low,2
shadowsocks-windows,1440,75,50,modified,36,14,shadowsocks-csharp/3rd/SimpleJson.cs,high,2
shadowsocks-windows,1440,75,0,removed,0,0,shadowsocks-csharp/Data/abp.js.gz,NaN,2
shadowsocks-windows,1440,75,88,modified,81,7,shadowsocks-csharp/Data/cn.txt,low,2
shadowsocks-windows,1440,75,0,modified,0,0,shadowsocks-csharp/Data/libsscrypto.dll.gz,NaN,3
shadowsocks-windows,1440,75,0,added,0,0,shadowsocks-csharp/Data/mgwz.dll.gz,NaN,2
shadowsocks-windows,1440,75,0,removed,0,0,shadowsocks-csharp/Data/polipo.exe.gz,NaN,2
shadowsocks-windows,1440,75,10,removed,0,10,shadowsocks-csharp/Data/polipo_config.txt,low,2
shadowsocks-windows,1438,2,1,modified,1,0,shadowsocks-csharp/Data/ja.txt,low,1
shadowsocks-windows,1438,2,1,modified,1,0,shadowsocks-csharp/Data/zh_CN.txt,low,3
shadowsocks-windows,1438,2,1,modified,1,0,shadowsocks-csharp/Data/zh_TW.txt,low,1
shadowsocks-windows,1438,2,136,modified,78,58,shadowsocks-csharp/View/ConfigForm.Designer.cs,high,1
shadowsocks-windows,1438,2,6,modified,6,0,shadowsocks-csharp/View/ConfigForm.cs,high,1
shadowsocks-windows,1438,2,108,modified,108,0,shadowsocks-csharp/View/ConfigForm.resx,medium,0
shadowsocks-windows,1438,2,4,modified,2,2,shadowsocks-csharp/shadowsocks-csharp.csproj,low,3
shadowsocks-windows,1384,2,7,removed,0,7,.gitignore,low,4
shadowsocks-windows,1384,2,89,removed,0,89,CHANGES,NaN,2
shadowsocks-windows,1384,2,28,removed,0,28,CONTRIBUTING.md,low,1
shadowsocks-windows,1384,2,118,removed,0,118,LICENSE.txt,low,2
shadowsocks-windows,1384,2,46,modified,1,45,README.md,low,5
shadowsocks-windows,1328,0,11,modified,0,11,shadowsocks-csharp/Data/ja.txt,low,2
shadowsocks-windows,1328,0,11,modified,0,11,shadowsocks-csharp/Data/zh_CN.txt,low,4
shadowsocks-windows,1328,0,11,modified,0,11,shadowsocks-csharp/Data/zh_TW.txt,low,2
shadowsocks-windows,1328,0,120,removed,0,120,shadowsocks-csharp/View/ProxyForm.resx,medium,1
shadowsocks-windows,1328,0,10,modified,8,2,shadowsocks-csharp/app.manifest,medium,1
shadowsocks-windows,1328,0,16,modified,0,16,shadowsocks-csharp/shadowsocks-csharp.csproj,low,4
shadowsocks-windows,1298,2,1,modified,1,0,shadowsocks-csharp/shadowsocks-csharp.csproj,low,4
shadowsocks-windows,1298,2,132,modified,132,0,test/UnitTest.cs,high,2
shadowsocks-windows,1285,0,36,modified,16,20,shadowsocks-csharp/Proxy/Socks5Proxy.cs,high,3
shadowsocks-windows,1285,0,7,modified,1,6,shadowsocks-csharp/Util/Util.cs,high,5
shadowsocks-windows,1272,1,2,modified,1,1,README.md,low,6
shadowsocks-windows,1227,0,6,modified,5,1,README.md,low,7
shadowsocks-windows,1222,0,6,modified,5,1,README.md,low,8
shadowsocks-windows,1214,1,9,modified,8,1,shadowsocks-csharp/Controller/Service/TCPRelay.cs,high,1
shadowsocks-windows,1214,1,14,modified,14,0,shadowsocks-csharp/Controller/ShadowsocksController.cs,high,3
shadowsocks-windows,1214,1,5,modified,5,0,shadowsocks-csharp/Data/ja.txt,low,2
shadowsocks-windows,1214,1,5,modified,5,0,shadowsocks-csharp/Data/zh_CN.txt,low,4
shadowsocks-windows,1214,1,5,modified,5,0,shadowsocks-csharp/Data/zh_TW.txt,low,2
shadowsocks-windows,1184,227,11,added,11,0,.github/issue_template.md,low,1
shadowsocks-windows,1184,227,6,modified,6,0,.gitignore,low,5
shadowsocks-windows,1184,227,675,added,675,0,LICENSE,low,1
shadowsocks-windows,1184,227,118,removed,0,118,LICENSE.txt,low,3
shadowsocks-windows,1184,227,30,modified,11,19,README.md,low,9
shadowsocks-windows,1184,227,46,modified,34,12,shadowsocks-csharp.sln,low,4
shadowsocks-windows,1138,5,168,modified,84,84,shadowsocks-csharp/Data/ja.txt,low,2
shadowsocks-windows,1136,227,11,added,11,0,.github/issue_template.md,low,2
shadowsocks-windows,1136,227,6,modified,6,0,.gitignore,low,6
shadowsocks-windows,1136,227,675,added,675,0,LICENSE,low,2
shadowsocks-windows,1136,227,118,removed,0,118,LICENSE.txt,low,4
shadowsocks-windows,1136,227,30,modified,11,19,README.md,low,10
shadowsocks-windows,1136,227,46,modified,34,12,shadowsocks-csharp.sln,low,5
shadowsocks-windows,1130,12,6,modified,6,0,shadowsocks-csharp/View/HotkeySettingsForm.resx,medium,2
shadowsocks-windows,1130,12,1,modified,1,0,shadowsocks-csharp/shadowsocks-csharp.csproj,low,5
shadowsocks-windows,1117,1,9,modified,8,1,shadowsocks-csharp/Controller/Service/PrivoxyRunner.cs,high,2
shadowsocks-windows,1117,1,7,modified,7,0,shadowsocks-csharp/Controller/ShadowsocksController.cs,high,6
shadowsocks-windows,1117,1,5,modified,5,0,shadowsocks-csharp/Data/zh_CN.txt,low,6
shadowsocks-windows,1117,1,3,modified,3,0,shadowsocks-csharp/Model/Configuration.cs,high,3
shadowsocks-windows,1117,1,120,added,120,0,shadowsocks-csharp/View/PrivoxyForm.resx,medium,1
shadowsocks-windows,1117,1,10,modified,10,0,shadowsocks-csharp/shadowsocks-csharp.csproj,low,6
shadowsocks-windows,1087,2,12,modified,11,1,shadowsocks-csharp/Controller/System/SystemProxy.cs,high,1
shadowsocks-windows,1087,2,79,added,79,0,shadowsocks-csharp/Controller/System/UserProxy.cs,high,1
shadowsocks-windows,1087,2,0,modified,0,0,shadowsocks-csharp/Data/sysproxy.exe.gz,NaN,1
shadowsocks-windows,1087,2,0,modified,0,0,shadowsocks-csharp/Data/sysproxy64.exe.gz,NaN,1
shadowsocks-windows,1087,2,12,modified,12,0,shadowsocks-csharp/Util/SystemProxy/Sysproxy.cs,high,3
shadowsocks-windows,1087,2,1,modified,1,0,shadowsocks-csharp/shadowsocks-csharp.csproj,low,7
shadowsocks-windows,1083,2,24,modified,23,1,shadowsocks-csharp/View/MenuViewController.cs,high,4
shadowsocks-windows,1064,4,6,modified,3,3,shadowsocks-csharp/Controller/I18N.cs,high,4
shadowsocks-windows,1064,4,288,renamed,143,145,shadowsocks-csharp/Data/ja.txt,low,2
shadowsocks-windows,1064,4,0,renamed,0,0,shadowsocks-csharp/Data/zh_CN.txt,low,6
shadowsocks-windows,1064,4,288,renamed,143,145,shadowsocks-csharp/Data/zh_TW.txt,low,2
shadowsocks-windows,1064,4,167,modified,83,84,shadowsocks-csharp/Properties/Resources.Designer.cs,high,2
shadowsocks-windows,1064,4,14,modified,7,7,shadowsocks-csharp/Properties/Resources.resx,medium,2
shadowsocks-windows,1064,4,56,modified,28,28,shadowsocks-csharp/shadowsocks-csharp.csproj,low,7
shadowsocks-windows,1061,1,26,modified,16,10,shadowsocks-csharp/Controller/I18N.cs,high,5
shadowsocks-windows,1061,1,0,renamed,0,0,shadowsocks-csharp/Data/CHS.txt,low,1
shadowsocks-windows,1061,1,288,renamed,143,145,shadowsocks-csharp/Data/CHT.txt,low,1
shadowsocks-windows,1061,1,288,renamed,143,145,shadowsocks-csharp/Data/JPN.txt,low,1
shadowsocks-windows,1061,1,175,modified,87,88,shadowsocks-csharp/Properties/Resources.Designer.cs,high,3
shadowsocks-windows,1061,1,16,modified,8,8,shadowsocks-csharp/Properties/Resources.resx,medium,3
shadowsocks-windows,1061,1,6,modified,3,3,shadowsocks-csharp/shadowsocks-csharp.csproj,low,8
shadowsocks-windows,1060,0,13,modified,0,13,CHANGES,NaN,3
shadowsocks-windows,1060,0,38,modified,19,19,LICENSE.txt,low,5
shadowsocks-windows,1060,0,5,modified,5,0,README.md,low,11
shadowsocks-windows,1060,0,40,modified,23,17,shadowsocks-csharp/Controller/I18N.cs,high,6
shadowsocks-windows,1060,0,1,modified,0,1,shadowsocks-csharp/Data/cn.txt,low,3
shadowsocks-windows,1060,0,145,removed,0,145,shadowsocks-csharp/Data/jp.txt,low,1
shadowsocks-windows,1060,0,0,modified,0,0,shadowsocks-csharp/Data/sysproxy.exe.gz,NaN,2
shadowsocks-windows,1060,0,0,modified,0,0,shadowsocks-csharp/Data/sysproxy64.exe.gz,NaN,2
shadowsocks-windows,1060,0,165,modified,81,84,shadowsocks-csharp/Data/zh_tw.txt,low,1
shadowsocks-windows,1060,0,2,modified,1,1,shadowsocks-csharp/Encryption/IVEncryptor.cs,high,1
shadowsocks-windows,1060,0,2,modified,1,1,shadowsocks-csharp/Properties/AssemblyInfo.cs,high,1
shadowsocks-windows,1060,0,82,modified,25,57,shadowsocks-csharp/Properties/Resources.Designer.cs,high,4
shadowsocks-windows,1060,0,3,modified,0,3,shadowsocks-csharp/Properties/Resources.resx,medium,4
shadowsocks-windows,1060,0,45,modified,31,14,shadowsocks-csharp/Util/Util.cs,high,6
shadowsocks-windows,1060,0,27,modified,10,17,shadowsocks-csharp/View/MenuViewController.cs,high,5
shadowsocks-windows,1060,0,1,modified,0,1,shadowsocks-csharp/shadowsocks-csharp.csproj,low,9
shadowsocks-windows,1059,0,4,modified,4,0,shadowsocks-csharp/Controller/I18N.cs,high,6
shadowsocks-windows,1059,0,145,added,145,0,shadowsocks-csharp/Data/jp.txt,low,1
shadowsocks-windows,1059,0,82,modified,57,25,shadowsocks-csharp/Properties/Resources.Designer.cs,high,4
shadowsocks-windows,1059,0,3,modified,3,0,shadowsocks-csharp/Properties/Resources.resx,medium,4
shadowsocks-windows,1059,0,1,modified,1,0,shadowsocks-csharp/shadowsocks-csharp.csproj,low,9
shadowsocks-windows,1054,417,19,added,19,0,.github/issue_template.md,low,3
shadowsocks-windows,1054,417,104,modified,104,0,CHANGES,NaN,4
shadowsocks-windows,1054,417,666,modified,644,22,LICENSE.txt,low,6
shadowsocks-windows,1054,417,17,modified,12,5,README.md,low,12
shadowsocks-windows,1054,417,0,added,0,0,UpgradeLog.htm,low,1
shadowsocks-windows,1054,417,12,modified,6,6,nuget.config,medium,1
shadowsocks-windows,1053,1,63,modified,0,63,CHANGES,NaN,5
shadowsocks-windows,1053,1,38,modified,19,19,LICENSE.txt,low,7
shadowsocks-windows,1053,1,15,modified,9,6,README.md,low,13
shadowsocks-windows,1053,1,3,added,3,0,amendment_list.txt,low,1
shadowsocks-windows,1053,1,0,added,0,0,bug_report/bug.png,low,1
shadowsocks-windows,1053,1,8,modified,4,4,shadowsocks-csharp/FodyWeavers.xml,medium,1
shadowsocks-windows,1028,0,1,modified,1,0,shadowsocks-csharp/Data/zh_CN.txt,low,7
shadowsocks-windows,1028,0,2,modified,2,0,shadowsocks-csharp/Model/Configuration.cs,high,5
shadowsocks-windows,1028,0,10,modified,10,0,shadowsocks-csharp/Model/Server.cs,high,3
shadowsocks-windows,1028,0,53,modified,39,14,shadowsocks-csharp/View/LogForm.Designer.cs,high,1
shadowsocks-windows,1028,0,109,modified,109,0,shadowsocks-csharp/View/LogForm.cs,high,1
shadowsocks-windows,1028,0,3,modified,3,0,shadowsocks-csharp/View/LogForm.resx,medium,1
shadowsocks-windows,1028,0,4,modified,2,2,shadowsocks-csharp/View/MenuViewController.cs,high,6
shadowsocks-windows,1028,0,4,modified,4,0,shadowsocks-csharp/shadowsocks-csharp.csproj,low,10
shadowsocks-windows,1023,1,6,modified,6,0,README.md,low,14
shadowsocks-windows,1023,1,19,modified,14,5,shadowsocks-csharp/Controller/Service/PrivoxyRunner.cs,high,6
shadowsocks-windows,1023,1,14,modified,11,3,shadowsocks-csharp/Util/Util.cs,high,7
shadowsocks-windows,1021,0,2,modified,1,1,shadowsocks-csharp/Data/zh_tw.txt,low,2
shadowsocks-windows,1006,0,6,modified,6,0,.gitignore,low,7
shadowsocks-windows,1006,0,675,added,675,0,LICENSE,low,3
shadowsocks-windows,1006,0,118,removed,0,118,LICENSE.txt,low,8
shadowsocks-windows,1006,0,30,modified,11,19,README.md,low,15
shadowsocks-windows,1006,0,46,modified,34,12,shadowsocks-csharp.sln,low,6
shadowsocks-windows,989,0,1,modified,1,0,shadowsocks-csharp/Data/cn.txt,low,4
shadowsocks-windows,989,0,1,modified,1,0,shadowsocks-csharp/Data/zh_tw.txt,low,2
shadowsocks-windows,978,2,1,modified,1,0,shadowsocks-csharp/Data/cn.txt,low,5
shadowsocks-windows,978,2,1,modified,1,0,shadowsocks-csharp/Data/zh_tw.txt,low,3
shadowsocks-windows,978,2,1,modified,1,0,shadowsocks-csharp/shadowsocks-csharp.csproj,low,11
shadowsocks-windows,973,0,164,modified,83,81,shadowsocks-csharp/Data/zh_tw.txt,low,3
shadowsocks-windows,955,4,2,modified,2,0,shadowsocks-csharp/Data/cn.txt,low,6
shadowsocks-windows,955,4,2,modified,2,0,shadowsocks-csharp/Data/zh_tw.txt,low,4
shadowsocks-windows,931,0,0,added,0,0,shadowsocks-csharp/Data/sysproxy.exe.gz,NaN,2
shadowsocks-windows,931,0,0,added,0,0,shadowsocks-csharp/Data/sysproxy64.exe.gz,NaN,2
shadowsocks-windows,931,0,20,modified,20,0,shadowsocks-csharp/Properties/Resources.Designer.cs,high,4
shadowsocks-windows,931,0,6,modified,6,0,shadowsocks-csharp/Properties/Resources.resx,medium,4
shadowsocks-windows,930,0,0,removed,0,0,shadowsocks-csharp/Data/mgwz.dll.gz,NaN,2
shadowsocks-windows,930,0,0,removed,0,0,shadowsocks-csharp/Data/privoxy.exe.gz,NaN,0
shadowsocks-windows,930,0,5,removed,0,5,shadowsocks-csharp/Data/privoxy_conf.txt,low,1
shadowsocks-windows,930,0,9,modified,0,9,shadowsocks-csharp/Properties/Resources.resx,medium,4
shadowsocks-windows,930,0,21,modified,9,12,shadowsocks-csharp/shadowsocks-csharp.csproj,low,11
shadowsocks-windows,928,1,6,modified,3,3,shadowsocks-csharp/Controller/System/SystemProxy.cs,high,3
shadowsocks-windows,928,1,0,added,0,0,shadowsocks-csharp/Data/sysproxy.exe.gz,NaN,3
shadowsocks-windows,928,1,0,added,0,0,shadowsocks-csharp/Data/sysproxy64.exe.gz,NaN,3
shadowsocks-windows,928,1,66,modified,43,23,shadowsocks-csharp/Properties/Resources.Designer.cs,high,5
shadowsocks-windows,928,1,6,modified,6,0,shadowsocks-csharp/Properties/Resources.resx,medium,5
shadowsocks-windows,918,0,1,modified,1,0,shadowsocks-csharp/shadowsocks-csharp.csproj,low,12
shadowsocks-windows,917,0,7,modified,5,2,shadowsocks-csharp/Model/Server.cs,high,3
windows,158,1,8,modified,4,4,Makefile,high,0
windows,156,1,4,modified,2,2,Makefile,high,0
windows,156,1,2,modified,1,1,eval-win2012r2-datacenter-cygwin.json,medium,0
windows,156,1,2,modified,1,1,eval-win2012r2-datacenter-ssh.json,medium,0
windows,156,1,2,modified,1,1,eval-win2012r2-datacenter.json,medium,0
windows,156,1,3,modified,1,2,eval-win2012r2-standard-cygwin.json,medium,0
windows,156,1,3,modified,1,2,eval-win2012r2-standard-ssh.json,medium,0
windows,156,1,2,modified,1,1,eval-win2012r2-standard.json,medium,0
windows,156,1,3,modified,1,2,eval-win2016-standard-cygwin.json,medium,0
windows,156,1,2,modified,1,1,eval-win2016-standard-ssh.json,medium,0
windows,156,1,2,modified,1,1,eval-win2016-standard.json,medium,0
windows,154,1,2,modified,1,1,floppy/disablewinupdate.bat,medium,0
windows,152,1,19,modified,10,9,Makefile,high,0
windows,146,1,8,modified,4,4,Makefile,high,0
windows,145,1,16,modified,10,6,eval-win10x64-enterprise-cygwin.json,medium,0
windows,145,1,16,modified,10,6,eval-win10x64-enterprise-ssh.json,medium,0
windows,145,1,16,modified,10,6,eval-win10x64-enterprise.json,medium,0
windows,145,1,16,modified,10,6,eval-win10x86-enterprise-cygwin.json,medium,0
windows,145,1,16,modified,10,6,eval-win10x86-enterprise-ssh.json,medium,0
windows,145,1,16,modified,10,6,eval-win10x86-enterprise.json,medium,0
windows,145,1,16,modified,10,6,eval-win2008r2-datacenter-cygwin.json,medium,0
windows,145,1,16,modified,10,6,eval-win2008r2-datacenter-ssh.json,medium,0
windows,145,1,16,modified,10,6,eval-win2008r2-datacenter.json,medium,0
windows,145,1,16,modified,10,6,eval-win2008r2-standard-cygwin.json,medium,0
windows,145,1,16,modified,10,6,eval-win2008r2-standard-ssh.json,medium,0
windows,145,1,16,modified,10,6,eval-win2008r2-standard.json,medium,0
windows,145,1,16,modified,10,6,eval-win2012r2-datacenter-cygwin.json,medium,0
windows,145,1,16,modified,10,6,eval-win2012r2-datacenter-ssh.json,medium,0
windows,145,1,16,modified,10,6,eval-win2012r2-datacenter.json,medium,0
windows,145,1,16,modified,10,6,eval-win2012r2-standard-cygwin.json,medium,0
windows,145,1,16,modified,10,6,eval-win2012r2-standard-ssh.json,medium,0
windows,145,1,16,modified,10,6,eval-win2012r2-standard.json,medium,0
windows,145,1,16,modified,10,6,eval-win2016-standard-cygwin.json,medium,0
windows,145,1,16,modified,10,6,eval-win2016-standard-ssh.json,medium,0
windows,145,1,16,modified,10,6,eval-win2016-standard.json,medium,0
windows,145,1,10,modified,7,3,eval-win7x64-enterprise-cygwin.json,medium,0
windows,145,1,16,modified,10,6,eval-win7x64-enterprise-ssh.json,medium,0
windows,145,1,16,modified,10,6,eval-win7x64-enterprise.json,medium,0
windows,145,1,16,modified,10,6,eval-win7x86-enterprise-cygwin.json,medium,0
windows,145,1,16,modified,10,6,eval-win7x86-enterprise-ssh.json,medium,0
windows,145,1,16,modified,10,6,eval-win7x86-enterprise.json,medium,0
windows,145,1,16,modified,10,6,eval-win81x64-enterprise-cygwin.json,medium,0
windows,145,1,16,modified,10,6,eval-win81x64-enterprise-ssh.json,medium,0
windows,145,1,16,modified,10,6,eval-win81x64-enterprise.json,medium,0
windows,143,1,3,modified,3,0,eval-win10x64-enterprise-cygwin.json,medium,0
windows,143,1,3,modified,3,0,eval-win10x64-enterprise-ssh.json,medium,0
windows,143,1,3,modified,3,0,eval-win10x64-enterprise.json,medium,0
windows,143,1,3,modified,3,0,eval-win10x86-enterprise-cygwin.json,medium,0
windows,143,1,3,modified,3,0,eval-win10x86-enterprise-ssh.json,medium,0
windows,143,1,3,modified,3,0,eval-win10x86-enterprise.json,medium,0
windows,143,1,36,added,36,0,floppy/slim_win10.bat,medium,0
windows,142,1,2,modified,1,1,script/vmtool.bat,medium,0
windows,141,1,4,modified,2,2,script/cmtool.bat,medium,0
windows,140,1,4,modified,2,2,eval-win10x64-enterprise-cygwin.json,medium,0
windows,140,1,4,modified,2,2,eval-win10x64-enterprise-ssh.json,medium,0
windows,140,1,6,modified,3,3,eval-win10x64-enterprise.json,medium,0
windows,140,1,4,modified,2,2,eval-win10x86-enterprise-cygwin.json,medium,0
windows,140,1,4,modified,2,2,eval-win10x86-enterprise-ssh.json,medium,0
windows,140,1,4,modified,2,2,eval-win10x86-enterprise.json,medium,0
windows,139,8,2,modified,1,1,VERSION,NaN,1
windows,139,8,43,added,43,0,buildserver/scaleway-virtualbox-module-build.sh,high,1
windows,139,8,12,modified,8,4,eval-win7x64-enterprise.json,medium,1
windows,139,8,7,modified,4,3,eval-win7x86-enterprise.json,medium,1
windows,139,8,2,modified,1,1,floppy/_packer_config.cmd,medium,1
windows,139,8,2,renamed,1,1,floppy/xx-update.bat,medium,1
windows,139,8,3,modified,1,2,script/enable-rdp.cmd,medium,1
windows,139,8,2,modified,1,1,script/sdelete.bat,medium,1
windows,139,8,8,modified,4,4,script/ultradefrag.bat,medium,1
windows,139,8,7,modified,5,2,script/vmtool.bat,medium,1
windows,137,1,176,removed,0,176,eval-win8x64-enterprise-cygwin.json,medium,0
windows,137,1,174,removed,0,174,eval-win8x64-enterprise-ssh.json,medium,0
windows,137,1,168,removed,0,168,eval-win8x64-enterprise.json,medium,0
windows,137,1,145,removed,0,145,floppy/eval-win8x64-enterprise/Autounattend.xml,medium,0
windows,137,1,149,removed,0,149,floppy/win8x64-enterprise/Autounattend.xml,medium,0
windows,137,1,153,removed,0,153,floppy/win8x64-pro/Autounattend.xml,medium,0
windows,137,1,137,removed,0,137,floppy/win8x86-enterprise/Autounattend.xml,medium,0
windows,137,1,141,removed,0,141,floppy/win8x86-pro/Autounattend.xml,medium,0
windows,137,1,43,removed,0,43,tpl/vagrantfile-eval-win8x64-enterprise-cygwin.tpl,NaN,0
windows,137,1,43,removed,0,43,tpl/vagrantfile-eval-win8x64-enterprise-ssh.tpl,NaN,0
windows,137,1,43,removed,0,43,tpl/vagrantfile-eval-win8x64-enterprise.tpl,NaN,0
windows,137,1,43,removed,0,43,tpl/vagrantfile-win8x64-enterprise-cygwin.tpl,NaN,0
windows,137,1,43,removed,0,43,tpl/vagrantfile-win8x64-enterprise-ssh.tpl,NaN,0
windows,137,1,43,removed,0,43,tpl/vagrantfile-win8x64-enterprise.tpl,NaN,0
windows,137,1,43,removed,0,43,tpl/vagrantfile-win8x64-pro-cygwin.tpl,NaN,0
windows,137,1,43,removed,0,43,tpl/vagrantfile-win8x64-pro-ssh.tpl,NaN,0
windows,137,1,43,removed,0,43,tpl/vagrantfile-win8x64-pro.tpl,NaN,0
windows,137,1,43,removed,0,43,tpl/vagrantfile-win8x86-enterprise-cygwin.tpl,NaN,0
windows,137,1,43,removed,0,43,tpl/vagrantfile-win8x86-enterprise-ssh.tpl,NaN,0
windows,137,1,43,removed,0,43,tpl/vagrantfile-win8x86-enterprise.tpl,NaN,0
windows,137,1,43,removed,0,43,tpl/vagrantfile-win8x86-pro-cygwin.tpl,NaN,0
windows,137,1,43,removed,0,43,tpl/vagrantfile-win8x86-pro-ssh.tpl,NaN,0
windows,137,1,43,removed,0,43,tpl/vagrantfile-win8x86-pro.tpl,NaN,0
windows,137,1,177,removed,0,177,win8x64-enterprise-cygwin.json,medium,0
windows,137,1,174,removed,0,174,win8x64-enterprise-ssh.json,medium,0
windows,137,1,167,removed,0,167,win8x64-enterprise.json,medium,0
windows,137,1,177,removed,0,177,win8x64-pro-cygwin.json,medium,0
windows,137,1,174,removed,0,174,win8x64-pro-ssh.json,medium,0
windows,137,1,167,removed,0,167,win8x64-pro.json,medium,0
windows,137,1,171,removed,0,171,win8x86-enterprise-cygwin.json,medium,0
windows,136,1,5,modified,3,2,script/vmtool.bat,medium,1
windows,135,1,3,modified,3,0,eval-win10x64-enterprise-cygwin.json,medium,0
windows,135,1,3,modified,3,0,eval-win10x64-enterprise-ssh.json,medium,0
windows,135,1,3,modified,3,0,eval-win10x64-enterprise.json,medium,0
windows,135,1,3,modified,3,0,eval-win10x86-enterprise-cygwin.json,medium,0
windows,135,1,3,modified,3,0,eval-win10x86-enterprise-ssh.json,medium,0
windows,135,1,3,modified,3,0,eval-win10x86-enterprise.json,medium,0
windows,135,1,10,added,10,0,floppy/autologon.bat,medium,0
windows,133,1,4,modified,2,2,eval-win2016-standard-cygwin.json,medium,0
windows,133,1,4,modified,2,2,eval-win2016-standard-ssh.json,medium,0
windows,133,1,4,modified,2,2,eval-win2016-standard.json,medium,0
windows,130,5,27,modified,27,0,Makefile,high,0
windows,130,5,187,added,187,0,eval-win2016-standard-cygwin.json,medium,0
windows,130,5,184,added,184,0,eval-win2016-standard-ssh.json,medium,0
windows,130,5,178,added,178,0,eval-win2016-standard.json,medium,0
windows,130,5,3,modified,2,1,floppy/cygwin.bat,medium,0
windows,130,5,153,added,153,0,floppy/eval-win2016-standard/Autounattend.xml,medium,0
windows,130,5,155,added,155,0,floppy/win2016-standard/Autounattend.xml,medium,0
windows,130,5,2,modified,1,1,script/cmtool.bat,medium,0
windows,130,5,43,added,43,0,tpl/vagrantfile-eval-win2016-standard-cygwin.tpl,NaN,0
windows,130,5,43,added,43,0,tpl/vagrantfile-eval-win2016-standard-ssh.tpl,NaN,0
windows,130,5,43,added,43,0,tpl/vagrantfile-eval-win2016-standard.tpl,NaN,0
windows,130,5,43,added,43,0,tpl/vagrantfile-win2016-standard-cygwin.tpl,NaN,0
windows,130,5,43,added,43,0,tpl/vagrantfile-win2016-standard-ssh.tpl,NaN,0
windows,130,5,43,added,43,0,tpl/vagrantfile-win2016-standard.tpl,NaN,0
windows,130,5,187,added,187,0,win2016-standard-cygwin.json,medium,0
windows,130,5,184,added,184,0,win2016-standard-ssh.json,medium,0
windows,130,5,178,added,178,0,win2016-standard.json,medium,0
windows,129,1,2,modified,1,1,script/ultradefrag.bat,medium,1
windows,129,1,2,modified,1,1,script/uninstall-7zip.bat,medium,0
windows,128,2,2,modified,1,1,eval-win10x64-enterprise-cygwin.json,medium,0
windows,128,2,2,modified,1,1,eval-win10x64-enterprise-ssh.json,medium,0
windows,128,2,2,modified,1,1,eval-win10x64-enterprise.json,medium,0
windows,128,2,2,modified,1,1,eval-win10x86-enterprise-cygwin.json,medium,0
windows,128,2,3,modified,1,2,eval-win10x86-enterprise-ssh.json,medium,0
windows,128,2,2,modified,1,1,eval-win10x86-enterprise.json,medium,0
windows,128,2,3,modified,1,2,eval-win81x64-enterprise-cygwin.json,medium,0
windows,128,2,4,modified,2,2,script/vmtool.bat,medium,1
windows,123,1,2,modified,1,1,script/sdelete.bat,medium,1
windows,118,1,6,modified,3,3,script/clean.bat,medium,0
windows,117,1,44,modified,26,18,eval-win10x64-enterprise-cygwin.json,medium,0
windows,117,1,42,modified,24,18,eval-win10x64-enterprise-ssh.json,medium,0
windows,117,1,4,modified,4,0,eval-win10x64-enterprise.json,medium,0
windows,117,1,44,modified,26,18,eval-win10x86-enterprise-cygwin.json,medium,0
windows,117,1,37,modified,23,14,eval-win10x86-enterprise-ssh.json,medium,0
windows,117,1,6,modified,6,0,eval-win10x86-enterprise.json,medium,0
windows,116,1,7,modified,6,1,floppy/win7x64-enterprise/Autounattend.xml,medium,0
windows,116,1,5,modified,4,1,floppy/win7x64-pro/Autounattend.xml,medium,0
windows,116,1,5,modified,4,1,floppy/win7x86-enterprise/Autounattend.xml,medium,0
windows,116,1,5,modified,4,1,floppy/win7x86-pro/Autounattend.xml,medium,0
windows,116,1,70,modified,36,34,floppy/win81x64-enterprise/Autounattend.xml,medium,0
windows,116,1,74,modified,38,36,floppy/win81x64-pro/Autounattend.xml,medium,0
windows,116,1,87,modified,51,36,floppy/win81x86-enterprise/Autounattend.xml,medium,0
windows,116,1,74,modified,38,36,floppy/win81x86-pro/Autounattend.xml,medium,0
windows,116,1,6,modified,5,1,floppy/win8x64-enterprise/Autounattend.xml,medium,0
windows,116,1,3,modified,2,1,floppy/win8x64-pro/Autounattend.xml,medium,0
windows,116,1,10,modified,6,4,floppy/win8x86-enterprise/Autounattend.xml,medium,0
windows,116,1,5,modified,3,2,floppy/win8x86-pro/Autounattend.xml,medium,0
windows,115,1,4,modified,2,2,script/clean.bat,medium,0
windows,114,1,8,modified,7,1,floppy/eval-win10x64-enterprise/Autounattend.xml,medium,0
windows,114,1,8,modified,7,1,floppy/eval-win10x86-enterprise/Autounattend.xml,medium,0
windows,113,1,4,modified,2,2,floppy/install-winrm.cmd,medium,0
windows,112,1,3,modified,1,2,script/sdelete.bat,medium,1
windows,111,1,2,modified,1,1,floppy/unzip.vbs,high,0
windows,110,1,6,modified,3,3,eval-win10x64-enterprise-cygwin.json,medium,0
windows,110,1,6,modified,3,3,eval-win10x64-enterprise-ssh.json,medium,0
windows,110,1,6,modified,3,3,eval-win10x64-enterprise.json,medium,0
windows,110,1,6,modified,3,3,eval-win10x86-enterprise-cygwin.json,medium,0
windows,110,1,6,modified,3,3,eval-win10x86-enterprise-ssh.json,medium,0
windows,110,1,6,modified,3,3,eval-win10x86-enterprise.json,medium,0
windows,108,1,6,modified,3,3,eval-win2008r2-datacenter-cygwin.json,medium,0
windows,108,1,6,modified,3,3,eval-win2008r2-datacenter-ssh.json,medium,0
windows,108,1,6,modified,3,3,eval-win2008r2-datacenter.json,medium,0
windows,108,1,6,modified,3,3,eval-win2008r2-standard-cygwin.json,medium,0
windows,108,1,6,modified,3,3,eval-win2008r2-standard-ssh.json,medium,0
windows,108,1,6,modified,3,3,eval-win2008r2-standard.json,medium,0
windows,108,1,6,modified,3,3,eval-win2012r2-datacenter-cygwin.json,medium,0
windows,108,1,6,modified,3,3,eval-win2012r2-datacenter-ssh.json,medium,0
windows,108,1,6,modified,3,3,eval-win2012r2-datacenter.json,medium,0
windows,108,1,6,modified,3,3,eval-win2012r2-standard-cygwin.json,medium,0
windows,108,1,6,modified,3,3,eval-win2012r2-standard-ssh.json,medium,0
windows,108,1,6,modified,3,3,eval-win2012r2-standard.json,medium,0
windows,108,1,6,modified,3,3,eval-win7x64-enterprise-cygwin.json,medium,0
windows,108,1,6,modified,3,3,eval-win7x64-enterprise-ssh.json,medium,0
windows,108,1,6,modified,3,3,eval-win7x64-enterprise.json,medium,1
windows,108,1,6,modified,3,3,eval-win7x86-enterprise-cygwin.json,medium,0
windows,108,1,6,modified,3,3,eval-win7x86-enterprise-ssh.json,medium,0
windows,108,1,6,modified,3,3,eval-win7x86-enterprise.json,medium,1
windows,108,1,6,modified,3,3,eval-win81x64-enterprise-cygwin.json,medium,0
windows,108,1,6,modified,3,3,eval-win81x64-enterprise-ssh.json,medium,0
windows,108,1,6,modified,3,3,eval-win81x64-enterprise.json,medium,0
windows,108,1,6,modified,3,3,eval-win81x86-enterprise-cygwin.json,medium,0
windows,108,1,6,modified,3,3,eval-win81x86-enterprise-ssh.json,medium,0
windows,108,1,6,modified,3,3,eval-win81x86-enterprise.json,medium,0
windows,108,1,7,modified,3,4,eval-win8x64-enterprise-cygwin.json,medium,0
windows,108,1,6,modified,3,3,eval-win8x64-enterprise-ssh.json,medium,0
windows,108,1,6,modified,3,3,eval-win8x64-enterprise.json,medium,0
windows,108,1,2,modified,1,1,floppy/_packer_config.cmd,medium,1
windows,108,1,0,renamed,0,0,floppy/zz-start-transports.cmd,medium,0
windows,108,1,6,modified,3,3,win2008r2-datacenter-cygwin.json,medium,0
windows,107,1,2,modified,1,1,.windows/provisions/Makefile,high,0
windows,107,1,4,modified,2,2,script/ultradefrag.bat,medium,1
windows,106,1,12,modified,6,6,eval-win10x64-enterprise-cygwin.json,medium,0
windows,106,1,12,modified,6,6,eval-win10x64-enterprise-ssh.json,medium,0
windows,106,1,12,modified,6,6,eval-win10x64-enterprise.json,medium,0
windows,106,1,12,modified,6,6,eval-win10x86-enterprise-cygwin.json,medium,0
windows,106,1,12,modified,6,6,eval-win10x86-enterprise-ssh.json,medium,0
windows,106,1,12,modified,6,6,eval-win10x86-enterprise.json,medium,0
windows,106,1,12,modified,6,6,eval-win2008r2-datacenter-cygwin.json,medium,0
windows,106,1,12,modified,6,6,eval-win2008r2-datacenter-ssh.json,medium,0
windows,106,1,12,modified,6,6,eval-win2008r2-datacenter.json,medium,0
windows,106,1,12,modified,6,6,eval-win2008r2-standard-cygwin.json,medium,0
windows,106,1,12,modified,6,6,eval-win2008r2-standard-ssh.json,medium,0
windows,106,1,12,modified,6,6,eval-win2008r2-standard.json,medium,0
windows,106,1,12,modified,6,6,eval-win2012r2-datacenter-cygwin.json,medium,0
windows,106,1,12,modified,6,6,eval-win2012r2-datacenter-ssh.json,medium,0
windows,106,1,12,modified,6,6,eval-win2012r2-datacenter.json,medium,0
windows,106,1,12,modified,6,6,eval-win2012r2-standard-cygwin.json,medium,0
windows,106,1,12,modified,6,6,eval-win2012r2-standard-ssh.json,medium,0
windows,106,1,12,modified,6,6,eval-win2012r2-standard.json,medium,0
windows,106,1,6,modified,3,3,eval-win7x86-enterprise-cygwin.json,medium,0
windows,106,1,6,modified,3,3,eval-win7x86-enterprise-ssh.json,medium,0
windows,106,1,6,modified,3,3,eval-win7x86-enterprise.json,medium,1
windows,106,1,12,modified,6,6,eval-win81x64-enterprise-cygwin.json,medium,0
windows,106,1,12,modified,6,6,eval-win81x64-enterprise-ssh.json,medium,0
windows,106,1,12,modified,6,6,eval-win81x64-enterprise.json,medium,0
windows,106,1,12,modified,6,6,eval-win81x86-enterprise-cygwin.json,medium,0
windows,106,1,12,modified,6,6,eval-win81x86-enterprise-ssh.json,medium,0
windows,106,1,12,modified,6,6,eval-win81x86-enterprise.json,medium,0
windows,106,1,12,modified,6,6,eval-win8x64-enterprise-cygwin.json,medium,0
windows,106,1,12,modified,6,6,eval-win8x64-enterprise-ssh.json,medium,0
windows,106,1,12,modified,6,6,eval-win8x64-enterprise.json,medium,0
windows,105,1,3,modified,3,0,floppy/powerconfig.bat,medium,0
windows,104,1,12,modified,6,6,eval-win7x64-enterprise-cygwin.json,medium,0
windows,104,1,12,modified,6,6,eval-win7x64-enterprise-ssh.json,medium,0
windows,104,1,14,modified,7,7,eval-win7x64-enterprise.json,medium,1
windows,104,1,6,modified,3,3,eval-win7x86-enterprise-cygwin.json,medium,0
windows,104,1,6,modified,3,3,eval-win7x86-enterprise-ssh.json,medium,0
windows,104,1,6,modified,3,3,eval-win7x86-enterprise.json,medium,1
windows,103,3,17,modified,16,1,script/clean.bat,medium,0
windows,102,3,40,modified,23,17,eval-win10x64-enterprise-cygwin.json,medium,1
windows,102,3,38,modified,21,17,eval-win10x64-enterprise-ssh.json,medium,1
windows,102,3,17,modified,7,10,eval-win10x64-enterprise.json,medium,1
windows,102,3,40,modified,23,17,eval-win10x86-enterprise-cygwin.json,medium,1
windows,102,3,34,modified,20,14,eval-win10x86-enterprise-ssh.json,medium,1
windows,102,3,19,modified,9,10,eval-win10x86-enterprise.json,medium,1
windows,102,3,6,modified,3,3,eval-win2008r2-datacenter-cygwin.json,medium,1
windows,102,3,6,modified,3,3,eval-win2008r2-datacenter-ssh.json,medium,1
windows,102,3,19,modified,6,13,eval-win2008r2-datacenter.json,medium,1
windows,102,3,6,modified,3,3,eval-win2008r2-standard-cygwin.json,medium,1
windows,102,3,6,modified,3,3,eval-win2008r2-standard-ssh.json,medium,1
windows,102,3,19,modified,6,13,eval-win2008r2-standard.json,medium,1
windows,102,3,6,modified,3,3,eval-win2012r2-datacenter-cygwin.json,medium,1
windows,102,3,6,modified,3,3,eval-win2012r2-datacenter-ssh.json,medium,1
windows,102,3,19,modified,6,13,eval-win2012r2-datacenter.json,medium,1
windows,102,3,6,modified,3,3,eval-win2012r2-standard-cygwin.json,medium,1
windows,102,3,6,modified,3,3,eval-win2012r2-standard-ssh.json,medium,1
windows,102,3,19,modified,9,10,eval-win2012r2-standard.json,medium,1
windows,102,3,52,modified,29,23,eval-win7x64-enterprise-cygwin.json,medium,1
windows,102,3,43,modified,23,20,eval-win7x64-enterprise-ssh.json,medium,1
windows,102,3,19,modified,9,10,eval-win7x64-enterprise.json,medium,2
windows,102,3,52,modified,29,23,eval-win7x86-enterprise-cygwin.json,medium,1
windows,102,3,46,modified,26,20,eval-win7x86-enterprise-ssh.json,medium,1
windows,102,3,22,modified,12,10,eval-win7x86-enterprise.json,medium,2
windows,102,3,40,modified,23,17,eval-win81x64-enterprise-cygwin.json,medium,1
windows,102,3,38,modified,21,17,eval-win81x64-enterprise-ssh.json,medium,1
windows,102,3,16,modified,6,10,eval-win81x64-enterprise.json,medium,1
windows,102,3,9,modified,6,3,eval-win81x86-enterprise-cygwin.json,medium,1
windows,102,3,9,modified,6,3,eval-win81x86-enterprise-ssh.json,medium,1
windows,102,3,22,modified,9,13,eval-win81x86-enterprise.json,medium,1
windows,101,1,10,modified,5,5,Makefile,high,0
windows,101,1,4,modified,2,2,eval-win81x64-enterprise-cygwin.json,medium,1
windows,101,1,4,modified,2,2,eval-win81x64-enterprise-ssh.json,medium,1
windows,101,1,4,modified,2,2,eval-win81x64-enterprise.json,medium,1
windows,101,1,4,modified,2,2,eval-win81x86-enterprise-cygwin.json,medium,1
windows,101,1,4,modified,2,2,eval-win81x86-enterprise-ssh.json,medium,1
windows,101,1,4,modified,2,2,eval-win81x86-enterprise.json,medium,1
windows,101,1,4,modified,2,2,eval-win8x64-enterprise-cygwin.json,medium,0
windows,101,1,4,modified,2,2,eval-win8x64-enterprise-ssh.json,medium,0
windows,101,1,4,modified,2,2,eval-win8x64-enterprise.json,medium,0
windows,100,1,0,modified,0,0,floppy/oracle-cert.cer,NaN,0
windows,100,1,2,modified,1,1,script/vmtool.bat,medium,1
windows,99,2,8,modified,4,4,Makefile,high,0
windows,99,2,4,modified,2,2,eval-win10x64-enterprise-cygwin.json,medium,1
windows,99,2,4,modified,2,2,eval-win10x64-enterprise-ssh.json,medium,1
windows,99,2,4,modified,2,2,eval-win10x64-enterprise.json,medium,1
windows,99,2,4,modified,2,2,eval-win10x86-enterprise-cygwin.json,medium,1
windows,99,2,4,modified,2,2,eval-win10x86-enterprise-ssh.json,medium,1
windows,99,2,4,modified,2,2,eval-win10x86-enterprise.json,medium,1
windows,99,2,10,modified,5,5,floppy/update.bat,medium,0
windows,98,1,2,modified,1,1,eval-win10x64-enterprise-cygwin.json,medium,1
windows,98,1,2,modified,1,1,eval-win10x64-enterprise-ssh.json,medium,1
windows,98,1,2,modified,1,1,eval-win10x64-enterprise.json,medium,1
windows,98,1,2,modified,1,1,eval-win10x86-enterprise-cygwin.json,medium,1
windows,98,1,2,modified,1,1,eval-win10x86-enterprise-ssh.json,medium,1
windows,98,1,2,modified,1,1,eval-win10x86-enterprise.json,medium,1
windows,97,3,2,modified,1,1,.windows/provisions/Makefile,high,0
windows,97,3,4,modified,2,2,script/ultradefrag.bat,medium,1
windows,97,3,5,modified,2,3,script/uninstall-7zip.bat,medium,0
windows,97,3,6,modified,3,3,script/vmtool.bat,medium,1
windows,96,1,1,modified,1,0,eval-win10x64-enterprise-cygwin.json,medium,1
windows,96,1,1,modified,1,0,eval-win10x64-enterprise-ssh.json,medium,1
windows,96,1,1,modified,1,0,eval-win10x64-enterprise.json,medium,1
windows,96,1,1,modified,1,0,eval-win10x86-enterprise-cygwin.json,medium,1
windows,96,1,1,modified,1,0,eval-win10x86-enterprise-ssh.json,medium,1
windows,96,1,1,modified,1,0,eval-win10x86-enterprise.json,medium,1
windows,96,1,1,modified,1,0,eval-win2008r2-datacenter-cygwin.json,medium,1
windows,96,1,1,modified,1,0,eval-win2008r2-datacenter-ssh.json,medium,1
windows,96,1,1,modified,1,0,eval-win2008r2-datacenter.json,medium,1
windows,96,1,1,modified,1,0,eval-win2008r2-standard-cygwin.json,medium,1
windows,96,1,1,modified,1,0,eval-win2008r2-standard-ssh.json,medium,1
windows,96,1,1,modified,1,0,eval-win2008r2-standard.json,medium,1
windows,96,1,1,modified,1,0,eval-win2012r2-datacenter-cygwin.json,medium,1
windows,96,1,1,modified,1,0,eval-win2012r2-datacenter-ssh.json,medium,1
windows,96,1,1,modified,1,0,eval-win2012r2-datacenter.json,medium,1
windows,96,1,1,modified,1,0,eval-win2012r2-standard-cygwin.json,medium,1
windows,96,1,1,modified,1,0,eval-win2012r2-standard-ssh.json,medium,1
windows,96,1,1,modified,1,0,eval-win2012r2-standard.json,medium,1
windows,96,1,1,modified,1,0,eval-win7x64-enterprise-cygwin.json,medium,1
windows,96,1,1,modified,1,0,eval-win7x64-enterprise-ssh.json,medium,1
windows,96,1,1,modified,1,0,eval-win7x64-enterprise.json,medium,2
windows,96,1,1,modified,1,0,eval-win7x86-enterprise-cygwin.json,medium,1
windows,96,1,1,modified,1,0,eval-win7x86-enterprise-ssh.json,medium,1
windows,96,1,1,modified,1,0,eval-win7x86-enterprise.json,medium,2
windows,96,1,1,modified,1,0,eval-win81x64-enterprise-cygwin.json,medium,1
windows,96,1,1,modified,1,0,eval-win81x64-enterprise-ssh.json,medium,1
windows,96,1,1,modified,1,0,eval-win81x64-enterprise.json,medium,1
windows,96,1,1,modified,1,0,eval-win81x86-enterprise-cygwin.json,medium,1
windows,96,1,1,modified,1,0,eval-win81x86-enterprise-ssh.json,medium,1
windows,96,1,1,modified,1,0,eval-win81x86-enterprise.json,medium,1
windows,95,2,6,modified,2,4,Makefile,high,0
windows,95,2,2,modified,1,1,eval-win2012r2-standard-ssh.json,medium,1
windows,95,2,2,modified,1,1,eval-win2012r2-standard.json,medium,1
windows,94,1,14,modified,6,8,script/cmtool.bat,medium,0
windows,93,1,1,modified,0,1,eval-win10x64-enterprise-cygwin.json,medium,1
windows,93,1,1,modified,0,1,eval-win10x64-enterprise-ssh.json,medium,1
windows,93,1,1,modified,0,1,eval-win10x64-enterprise.json,medium,1
windows,93,1,1,modified,0,1,eval-win10x86-enterprise-cygwin.json,medium,1
windows,93,1,1,modified,0,1,eval-win10x86-enterprise-ssh.json,medium,1
windows,93,1,1,modified,0,1,eval-win10x86-enterprise.json,medium,1
windows,93,1,1,modified,0,1,eval-win2008r2-datacenter-cygwin.json,medium,1
windows,93,1,1,modified,0,1,eval-win2008r2-datacenter-ssh.json,medium,1
windows,93,1,1,modified,0,1,eval-win2008r2-datacenter.json,medium,1
windows,93,1,1,modified,0,1,eval-win2008r2-standard-cygwin.json,medium,1
windows,93,1,1,modified,0,1,eval-win2008r2-standard-ssh.json,medium,1
windows,93,1,1,modified,0,1,eval-win2008r2-standard.json,medium,1
windows,93,1,1,modified,0,1,eval-win2012r2-datacenter-cygwin.json,medium,1
windows,93,1,1,modified,0,1,eval-win2012r2-datacenter-ssh.json,medium,1
windows,93,1,1,modified,0,1,eval-win2012r2-datacenter.json,medium,1
windows,93,1,1,modified,0,1,eval-win2012r2-standard-cygwin.json,medium,1
windows,93,1,1,modified,0,1,eval-win2012r2-standard-ssh.json,medium,1
windows,93,1,1,modified,0,1,eval-win2012r2-standard.json,medium,1
windows,93,1,1,modified,0,1,eval-win7x64-enterprise-cygwin.json,medium,1
windows,93,1,1,modified,0,1,eval-win7x64-enterprise-ssh.json,medium,1
windows,93,1,1,modified,0,1,eval-win7x64-enterprise.json,medium,2
windows,93,1,1,modified,0,1,eval-win7x86-enterprise-cygwin.json,medium,1
windows,93,1,1,modified,0,1,eval-win7x86-enterprise-ssh.json,medium,1
windows,93,1,1,modified,0,1,eval-win7x86-enterprise.json,medium,2
windows,93,1,1,modified,0,1,eval-win81x64-enterprise-cygwin.json,medium,1
windows,93,1,1,modified,0,1,eval-win81x64-enterprise-ssh.json,medium,1
windows,93,1,1,modified,0,1,eval-win81x64-enterprise.json,medium,1
windows,93,1,1,modified,0,1,eval-win81x86-enterprise-cygwin.json,medium,1
windows,93,1,1,modified,0,1,eval-win81x86-enterprise-ssh.json,medium,1
windows,93,1,1,modified,0,1,eval-win81x86-enterprise.json,medium,1
windows,92,1,0,modified,0,0,floppy/oracle-cert.cer,NaN,1
windows,91,1,5,modified,2,3,script/vmtool.bat,medium,1
windows,87,8,126,modified,106,20,script/cmtool.bat,medium,0
windows,86,5,103,modified,90,13,script/cmtool.bat,medium,1
windows,85,4,11,modified,9,2,floppy/01-install-wget.cmd,medium,0
windows,85,4,11,modified,9,2,floppy/_download.cmd,medium,0
windows,85,4,17,modified,17,0,floppy/_packer_config.cmd,medium,1
windows,85,4,7,modified,6,1,floppy/bitvisessh.bat,medium,0
windows,85,4,14,modified,11,3,floppy/cygwin.bat,medium,0
windows,85,4,2,modified,1,1,floppy/fixnetwork.ps1,high,0
windows,85,4,7,modified,6,1,floppy/hotfix-KB2842230.bat,medium,0
windows,85,4,12,modified,8,4,floppy/openssh.bat,medium,0
windows,85,4,6,modified,5,1,floppy/upgrade-wua.bat,medium,0
windows,83,1,61,added,61,0,floppy/install-cloudinit.cmd,medium,0
windows,82,1,181,added,181,0,eval-win10x64-enterprise-cuckoo.json,medium,1
windows,82,1,174,added,174,0,eval-win7x86-enterprise-cuckoo.json,medium,1
windows,82,1,51,added,51,0,script/cuckoo-agent.cmd,medium,1
windows,82,1,5,added,5,0,script/disable-firewall.cmd,medium,1
windows,82,1,5,added,5,0,script/disable-updates.cmd,medium,1
windows,82,1,52,added,52,0,script/oldfirefox.cmd,medium,1
windows,82,1,51,added,51,0,script/oldflash.cmd,medium,1
windows,82,1,50,added,50,0,script/python-pil.cmd,medium,1
windows,82,1,50,added,50,0,script/python.cmd,medium,1
windows,79,1,10,modified,7,3,script/cmtool.bat,medium,2
windows,76,1,22,modified,20,2,floppy/_post_update_install.bat,medium,0
windows,75,1,33,added,33,0,floppy/install-features.cmd,medium,0
windows,75,1,33,added,33,0,floppy/remove-features.cmd,medium,0
windows,74,1,4,modified,2,2,script/cmtool.bat,medium,2
windows,73,1,1,modified,1,0,eval-win10x64-enterprise-cygwin.json,medium,1
windows,73,1,1,modified,1,0,eval-win10x64-enterprise-ssh.json,medium,1
windows,73,1,3,modified,2,1,eval-win10x64-enterprise.json,medium,1
windows,73,1,1,modified,1,0,eval-win10x86-enterprise-cygwin.json,medium,1
windows,73,1,1,modified,1,0,eval-win10x86-enterprise-ssh.json,medium,1
windows,73,1,3,modified,2,1,eval-win10x86-enterprise.json,medium,1
windows,73,1,1,modified,1,0,eval-win2008r2-datacenter-cygwin.json,medium,1
windows,73,1,1,modified,1,0,eval-win2008r2-datacenter-ssh.json,medium,1
windows,73,1,3,modified,2,1,eval-win2008r2-datacenter.json,medium,1
windows,73,1,1,modified,1,0,eval-win2008r2-standard-cygwin.json,medium,1
windows,73,1,1,modified,1,0,eval-win2008r2-standard-ssh.json,medium,1
windows,73,1,3,modified,2,1,eval-win2008r2-standard.json,medium,1
windows,73,1,1,modified,1,0,eval-win2012r2-datacenter-cygwin.json,medium,1
windows,73,1,1,modified,1,0,eval-win2012r2-datacenter-ssh.json,medium,1
windows,73,1,3,modified,2,1,eval-win2012r2-datacenter.json,medium,1
windows,73,1,1,modified,1,0,eval-win2012r2-standard-cygwin.json,medium,1
windows,73,1,1,modified,1,0,eval-win2012r2-standard-ssh.json,medium,1
windows,73,1,3,modified,2,1,eval-win2012r2-standard.json,medium,1
windows,73,1,1,modified,1,0,eval-win7x64-enterprise-cygwin.json,medium,1
windows,73,1,1,modified,1,0,eval-win7x64-enterprise-ssh.json,medium,1
windows,73,1,3,modified,2,1,eval-win7x64-enterprise.json,medium,2
windows,73,1,1,modified,1,0,eval-win7x86-enterprise-cygwin.json,medium,1
windows,73,1,1,modified,1,0,eval-win7x86-enterprise-ssh.json,medium,1
windows,73,1,3,modified,2,1,eval-win7x86-enterprise.json,medium,2
windows,73,1,1,modified,1,0,eval-win81x64-enterprise-cygwin.json,medium,1
windows,73,1,1,modified,1,0,eval-win81x64-enterprise-ssh.json,medium,1
windows,73,1,3,modified,2,1,eval-win81x64-enterprise.json,medium,1
windows,73,1,1,modified,1,0,eval-win81x86-enterprise-cygwin.json,medium,1
windows,73,1,1,modified,1,0,eval-win81x86-enterprise-ssh.json,medium,1
windows,73,1,3,modified,2,1,eval-win81x86-enterprise.json,medium,1
windows,70,1,4,modified,2,2,Makefile,high,1
windows,70,1,4,modified,2,2,floppy/eval-win10x64-enterprise/Autounattend.xml,medium,1
windows,69,1,6,modified,3,3,script/cmtool.bat,medium,2
windows,68,1,2,modified,1,1,bin/tweak-json.py,high,0
windows,67,1,4,modified,2,2,bin/tweak-json.py,high,0
windows,62,1,5,modified,5,0,floppy/_packer_config.cmd,medium,1
windows,62,1,48,added,48,0,floppy/pagefile.bat,medium,0
windows,60,1,2,modified,1,1,eval-win2012r2-standard-ssh.json,medium,1
windows,60,1,2,modified,1,1,eval-win2012r2-standard.json,medium,1
windows,58,0,5,added,5,0,floppy/_post_update_install.bat,medium,0
windows,58,0,15,modified,15,0,floppy/update.bat,medium,0
windows,54,1,2,modified,1,1,floppy/cygwin.bat,medium,0
windows,54,1,2,modified,1,1,floppy/install-winrm.cmd,medium,0
windows,52,1,4,modified,3,1,script/vmtool.bat,medium,1
windows,48,2,4,modified,2,2,eval-win10x64-enterprise.json,medium,1
windows,48,2,4,modified,2,2,eval-win10x86-enterprise.json,medium,1
windows,48,2,4,modified,2,2,eval-win2008r2-datacenter.json,medium,1
windows,48,2,4,modified,2,2,eval-win2008r2-standard.json,medium,1
windows,48,2,4,modified,2,2,eval-win2012r2-datacenter.json,medium,1
windows,48,2,4,modified,2,2,eval-win2012r2-standard.json,medium,1
windows,48,2,4,modified,2,2,eval-win7x64-enterprise.json,medium,2
windows,48,2,4,modified,2,2,eval-win7x86-enterprise.json,medium,2
windows,48,2,4,modified,2,2,eval-win81x64-enterprise.json,medium,1
windows,48,2,4,modified,2,2,eval-win81x86-enterprise.json,medium,1
windows,48,2,4,modified,2,2,eval-win8x64-enterprise.json,medium,0
windows,48,2,43,removed,0,43,tpl/vagrantfile-eval-win10x64-enterprise-ssh-ssh.tpl,NaN,0
windows,48,2,2,modified,1,1,tpl/vagrantfile-eval-win10x64-enterprise-ssh.tpl,NaN,0
windows,48,2,2,modified,1,1,tpl/vagrantfile-eval-win10x64-enterprise.tpl,NaN,0
windows,48,2,4,modified,2,2,tpl/vagrantfile-eval-win2008r2-datacenter-ssh.tpl,NaN,0
windows,48,2,4,modified,2,2,tpl/vagrantfile-eval-win2008r2-standard-ssh.tpl,NaN,0
windows,48,2,4,modified,2,2,tpl/vagrantfile-win2008r2-datacenter-ssh.tpl,NaN,0
windows,48,2,4,modified,2,2,tpl/vagrantfile-win2008r2-standardcore-ssh.tpl,NaN,0
windows,48,2,4,modified,2,2,tpl/vagrantfile-win2012r2-standardcore-ssh.tpl,NaN,0
windows,48,2,4,modified,2,2,win2008r2-datacenter.json,medium,0
windows,48,2,4,modified,2,2,win2008r2-enterprise.json,medium,0
windows,48,2,4,modified,2,2,win2008r2-standard.json,medium,0
windows,48,2,4,modified,2,2,win2008r2-web.json,medium,0
windows,48,2,4,modified,2,2,win2012-datacenter.json,medium,0
windows,48,2,4,modified,2,2,win2012-standard.json,medium,0
windows,48,2,4,modified,2,2,win2012r2-datacenter.json,medium,0
windows,48,2,4,modified,2,2,win2012r2-standard.json,medium,0
windows,48,2,8,modified,4,4,win2012r2-standardcore.json,medium,0
windows,48,2,4,modified,2,2,win7x64-enterprise.json,medium,0
windows,48,2,4,modified,2,2,win7x86-enterprise.json,medium,0
windows,47,1,2,modified,1,1,.windows/provisions/Makefile,high,0
windows,47,1,2,modified,1,1,floppy/01-install-wget.cmd,medium,0
windows,44,0,4,modified,2,2,eval-win10x64-enterprise-cygwin.json,medium,1
windows,44,0,4,modified,2,2,eval-win10x86-enterprise-cygwin.json,medium,1
windows,44,0,4,modified,2,2,eval-win2008r2-datacenter-cygwin.json,medium,1
windows,44,0,4,modified,2,2,eval-win2008r2-standard-cygwin.json,medium,1
windows,44,0,4,modified,2,2,eval-win2012r2-datacenter-cygwin.json,medium,1
windows,44,0,4,modified,2,2,eval-win2012r2-standard-cygwin.json,medium,1
windows,44,0,4,modified,2,2,eval-win7x64-enterprise-cygwin.json,medium,1
windows,44,0,4,modified,2,2,eval-win7x86-enterprise-cygwin.json,medium,1
windows,44,0,4,modified,2,2,eval-win81x64-enterprise-cygwin.json,medium,1
windows,44,0,4,modified,2,2,eval-win81x86-enterprise-cygwin.json,medium,1
windows,44,0,4,modified,2,2,eval-win8x64-enterprise-cygwin.json,medium,0
windows,44,0,4,modified,2,2,win2008r2-datacenter-cygwin.json,medium,0
windows,44,0,4,modified,2,2,win2008r2-enterprise-cygwin.json,medium,0
windows,44,0,4,modified,2,2,win2008r2-standard-cygwin.json,medium,0
windows,44,0,4,modified,2,2,win2008r2-web-cygwin.json,medium,0
windows,44,0,4,modified,2,2,win2012-datacenter-cygwin.json,medium,0
windows,44,0,4,modified,2,2,win2012-standard-cygwin.json,medium,0
windows,44,0,4,modified,2,2,win2012r2-datacenter-cygwin.json,medium,0
windows,44,0,4,modified,2,2,win2012r2-standard-cygwin.json,medium,0
windows,44,0,4,modified,2,2,win2012r2-standardcore-cygwin.json,medium,0
windows,44,0,4,modified,2,2,win7x64-enterprise-cygwin.json,medium,0
windows,44,0,4,modified,2,2,win7x64-pro-cygwin.json,medium,0
windows,44,0,4,modified,2,2,win7x86-enterprise-cygwin.json,medium,0
windows,44,0,4,modified,2,2,win7x86-pro-cygwin.json,medium,0
windows,44,0,4,modified,2,2,win81x64-enterprise-cygwin.json,medium,0
windows,44,0,4,modified,2,2,win81x64-pro-cygwin.json,medium,0
windows,44,0,4,modified,2,2,win81x86-enterprise-cygwin.json,medium,0
windows,44,0,4,modified,2,2,win81x86-pro-cygwin.json,medium,0
windows,44,0,4,modified,2,2,win8x64-enterprise-cygwin.json,medium,0
windows,44,0,4,modified,2,2,win8x64-pro-cygwin.json,medium,0
windows,39,1,3,modified,2,1,README.md,low,0
windows,38,0,9,modified,7,2,script/vmtool.bat,medium,1
windows,33,0,11,modified,9,2,script/cmtool.bat,medium,3
windows,30,2,4,modified,2,2,.windows/isos/Makefile,high,0
windows,30,2,8,modified,4,4,Makefile,high,1
windows,30,2,4,modified,2,2,eval-win10x64-enterprise-cygwin.json,medium,1
windows,30,2,4,modified,2,2,eval-win10x64-enterprise-ssh.json,medium,1
windows,30,2,4,modified,2,2,eval-win10x64-enterprise.json,medium,1
windows,30,2,4,modified,2,2,eval-win10x86-enterprise-cygwin.json,medium,1
windows,30,2,4,modified,2,2,eval-win10x86-enterprise-ssh.json,medium,1
windows,30,2,4,modified,2,2,eval-win10x86-enterprise.json,medium,1
windows,30,2,37,modified,19,18,floppy/eval-win10x64-enterprise/Autounattend.xml,medium,1
windows,30,2,57,modified,29,28,floppy/eval-win10x86-enterprise/Autounattend.xml,medium,0
windows,25,1,8,modified,4,4,Makefile,high,2
windows,25,1,5,modified,2,3,eval-win10x64-enterprise-cygwin.json,medium,2
windows,25,1,6,modified,3,3,eval-win10x64-enterprise-ssh.json,medium,2
windows,25,1,8,modified,2,6,eval-win10x64-enterprise.json,medium,2
windows,25,1,5,modified,2,3,eval-win10x86-enterprise-cygwin.json,medium,2
windows,25,1,6,modified,3,3,eval-win10x86-enterprise-ssh.json,medium,2
windows,25,1,248,modified,124,124,eval-win10x86-enterprise.json,medium,2
windows,25,1,3,modified,2,1,floppy/eval-win10x64-enterprise/Autounattend.xml,medium,2
windows,25,1,3,modified,2,1,floppy/eval-win10x86-enterprise/Autounattend.xml,medium,1
windows,22,0,6,modified,3,3,eval-win10x64-enterprise-cygwin.json,medium,2
windows,22,0,6,modified,3,3,eval-win10x64-enterprise.json,medium,2
windows,22,0,6,modified,3,3,eval-win10x86-enterprise-cygwin.json,medium,2
windows,22,0,6,modified,3,3,eval-win10x86-enterprise.json,medium,2
windows,22,0,6,modified,3,3,eval-win2008r2-datacenter-cygwin.json,medium,1
windows,22,0,6,modified,3,3,eval-win2008r2-datacenter.json,medium,1
windows,22,0,6,modified,3,3,eval-win2008r2-standard-cygwin.json,medium,1
windows,22,0,6,modified,3,3,eval-win2008r2-standard.json,medium,1
windows,22,0,6,modified,3,3,eval-win2012r2-datacenter-cygwin.json,medium,1
windows,22,0,6,modified,3,3,eval-win2012r2-datacenter.json,medium,1
windows,22,0,6,modified,3,3,eval-win2012r2-standard-cygwin.json,medium,1
windows,22,0,6,modified,3,3,eval-win2012r2-standard.json,medium,1
windows,22,0,6,modified,3,3,eval-win7x64-enterprise-cygwin.json,medium,1
windows,22,0,6,modified,3,3,eval-win7x64-enterprise.json,medium,2
windows,22,0,6,modified,3,3,eval-win7x86-enterprise-cygwin.json,medium,1
windows,22,0,6,modified,3,3,eval-win7x86-enterprise.json,medium,2
windows,22,0,6,modified,3,3,eval-win81x64-enterprise-cygwin.json,medium,1
windows,22,0,6,modified,3,3,eval-win81x64-enterprise.json,medium,1
windows,22,0,6,modified,3,3,eval-win81x86-enterprise-cygwin.json,medium,1
windows,22,0,6,modified,3,3,eval-win81x86-enterprise.json,medium,1
windows,22,0,6,modified,3,3,eval-win8x64-enterprise-cygwin.json,medium,0
windows,22,0,6,modified,3,3,eval-win8x64-enterprise.json,medium,0
windows,22,0,6,modified,3,3,win2008r2-datacenter-cygwin.json,medium,0
windows,22,0,6,modified,3,3,win2008r2-datacenter.json,medium,0
windows,22,0,6,modified,3,3,win2008r2-enterprise-cygwin.json,medium,0
windows,22,0,6,modified,3,3,win2008r2-enterprise.json,medium,0
windows,22,0,6,modified,3,3,win2008r2-standard-cygwin.json,medium,0
windows,22,0,6,modified,3,3,win2008r2-standard.json,medium,0
windows,22,0,6,modified,3,3,win2008r2-web-cygwin.json,medium,0
windows,22,0,6,modified,3,3,win2008r2-web.json,medium,0
windows,18,0,4,modified,2,2,Makefile,high,2
windows,18,0,4,modified,2,2,eval-win2012r2-datacenter-cygwin.json,medium,1
windows,18,0,4,modified,2,2,eval-win2012r2-datacenter.json,medium,1
windows,18,0,4,modified,2,2,eval-win2012r2-standard-cygwin.json,medium,1
windows,18,0,4,modified,2,2,eval-win2012r2-standard.json,medium,1
windows,15,1,10,modified,10,0,README.md,low,0
windows,9,0,18,modified,9,9,Makefile,high,2
windows,7,0,8,modified,5,3,eval-win10x64-enterprise-cygwin.json,medium,2
windows,7,0,8,modified,5,3,eval-win10x64-enterprise.json,medium,2
windows,7,0,8,modified,5,3,eval-win10x86-enterprise-cygwin.json,medium,2
windows,7,0,8,modified,5,3,eval-win10x86-enterprise.json,medium,2
windows,7,0,8,modified,5,3,eval-win2008r2-datacenter-cygwin.json,medium,1
windows,7,0,8,modified,5,3,eval-win2008r2-datacenter.json,medium,1
windows,7,0,8,modified,5,3,eval-win2008r2-standard-cygwin.json,medium,1
windows,7,0,8,modified,5,3,eval-win2008r2-standard.json,medium,1
windows,7,0,8,modified,5,3,eval-win2012r2-datacenter-cygwin.json,medium,1
windows,7,0,8,modified,5,3,eval-win2012r2-datacenter.json,medium,1
windows,7,0,8,modified,5,3,eval-win2012r2-standard-cygwin.json,medium,1
windows,7,0,8,modified,5,3,eval-win2012r2-standard.json,medium,1
windows,7,0,8,modified,5,3,eval-win7x64-enterprise-cygwin.json,medium,1
windows,7,0,8,modified,5,3,eval-win7x64-enterprise.json,medium,2
windows,7,0,8,modified,5,3,eval-win7x86-enterprise-cygwin.json,medium,1
windows,7,0,8,modified,5,3,eval-win7x86-enterprise.json,medium,2
windows,7,0,8,modified,5,3,eval-win81x64-enterprise-cygwin.json,medium,1
windows,7,0,8,modified,5,3,eval-win81x64-enterprise.json,medium,1
windows,7,0,8,modified,5,3,eval-win81x86-enterprise-cygwin.json,medium,1
windows,7,0,8,modified,5,3,eval-win81x86-enterprise.json,medium,1
windows,7,0,8,modified,5,3,eval-win8x64-enterprise-cygwin.json,medium,0
windows,7,0,8,modified,5,3,eval-win8x64-enterprise.json,medium,0
windows,7,0,8,modified,5,3,win2008r2-datacenter-cygwin.json,medium,0
windows,7,0,8,modified,5,3,win2008r2-datacenter.json,medium,0
windows,7,0,8,modified,5,3,win2008r2-enterprise-cygwin.json,medium,0
windows,7,0,8,modified,5,3,win2008r2-enterprise.json,medium,0
windows,7,0,8,modified,5,3,win2008r2-standard-cygwin.json,medium,0
windows,7,0,8,modified,5,3,win2008r2-standard.json,medium,0
windows,7,0,8,modified,5,3,win2008r2-web-cygwin.json,medium,0
windows,7,0,8,modified,5,3,win2008r2-web.json,medium,0
windows,6,0,6,modified,6,0,eval-win8x64-enterprise-cygwin.json,medium,0
windows,6,0,6,modified,6,0,eval-win8x64-enterprise.json,medium,0
windows,6,0,53,added,53,0,floppy/hotfix-KB2842230.bat,medium,0
windows,6,0,6,modified,6,0,win2012-datacenter-cygwin.json,medium,0
windows,6,0,6,modified,6,0,win2012-datacenter.json,medium,0
windows,6,0,6,modified,6,0,win2012-standard-cygwin.json,medium,0
windows,6,0,6,modified,6,0,win2012-standard.json,medium,0
windows,6,0,6,modified,6,0,win8x64-enterprise-cygwin.json,medium,0
windows,6,0,6,modified,6,0,win8x64-enterprise.json,medium,0
windows,6,0,6,modified,6,0,win8x64-pro-cygwin.json,medium,0
windows,6,0,6,modified,6,0,win8x64-pro.json,medium,0
windows,4,0,2,modified,1,1,floppy/01-install-wget.cmd,medium,0
windows,3,3,1,modified,1,0,AUTHORS,low,0
windows,3,3,3,modified,2,1,Makefile,high,2
windows,3,3,4,modified,4,0,eval-win10x64-enterprise-cygwin.json,medium,2
windows,3,3,4,modified,4,0,eval-win10x64-enterprise.json,medium,2
windows,3,3,4,modified,4,0,eval-win10x86-enterprise-cygwin.json,medium,2
windows,3,3,4,modified,4,0,eval-win10x86-enterprise.json,medium,2
windows,3,3,4,modified,4,0,eval-win2008r2-datacenter-cygwin.json,medium,1
windows,3,3,4,modified,4,0,eval-win2008r2-datacenter.json,medium,1
windows,3,3,4,modified,4,0,eval-win2008r2-standard-cygwin.json,medium,1
windows,3,3,4,modified,4,0,eval-win2008r2-standard.json,medium,1
windows,3,3,4,modified,4,0,eval-win2012r2-datacenter-cygwin.json,medium,1
windows,3,3,4,modified,4,0,eval-win2012r2-datacenter.json,medium,1
windows,3,3,4,modified,4,0,eval-win2012r2-standard-cygwin.json,medium,1
windows,3,3,4,modified,4,0,eval-win2012r2-standard.json,medium,1
windows,3,3,4,modified,4,0,eval-win7x64-enterprise-cygwin.json,medium,1
windows,3,3,4,modified,4,0,eval-win7x64-enterprise.json,medium,2
windows,3,3,4,modified,4,0,eval-win7x86-enterprise-cygwin.json,medium,1
windows,3,3,4,modified,4,0,eval-win7x86-enterprise.json,medium,2
windows,3,3,4,modified,4,0,eval-win81x64-enterprise-cygwin.json,medium,1
windows,3,3,4,modified,4,0,eval-win81x64-enterprise.json,medium,1
windows,3,3,4,modified,4,0,eval-win81x86-enterprise-cygwin.json,medium,1
windows,3,3,4,modified,4,0,eval-win81x86-enterprise.json,medium,1
windows,3,3,4,modified,4,0,eval-win8x64-enterprise-cygwin.json,medium,0
windows,3,3,4,modified,4,0,eval-win8x64-enterprise.json,medium,0
windows,3,3,4,modified,4,0,win2008r2-datacenter-cygwin.json,medium,0
windows,3,3,4,modified,4,0,win2008r2-datacenter.json,medium,0
windows,3,3,4,modified,4,0,win2008r2-enterprise-cygwin.json,medium,0
windows,3,3,4,modified,4,0,win2008r2-enterprise.json,medium,0
windows,3,3,4,modified,4,0,win2008r2-standard-cygwin.json,medium,0
windows,3,3,4,modified,4,0,win2008r2-standard.json,medium,0
windows,2,0,4,modified,2,2,Makefile,high,2
windows,2,0,5,modified,2,3,win2012r2-standard.json,medium,0
windows,2,0,5,modified,2,3,win2012r2-standardcore-cygwin.json,medium,0
windows,2,0,5,modified,2,3,win2012r2-standardcore.json,medium,0
windows95,96,0,6,modified,3,3,README.md,low,0
windows95,89,1,6,modified,2,4,docs/docker-instructions.md,low,0
windows95,87,1,10,modified,10,0,docs/docker-instructions.md,low,0
windows95,66,1,4,modified,4,0,forge.config.js,high,0
windows95,66,1,1,modified,1,0,package.json,medium,0
windows95,52,5,45,added,45,0,Dockerfile,low,0
windows95,52,5,3,modified,3,0,README.md,low,0
windows95,52,5,25,added,25,0,docs/docker-instructions.md,low,0
windows95,17,3,15,modified,13,2,README.md,low,0
windows95,17,3,4,modified,4,0,src/renderer/renderer.js,high,0
windows95,16,2,10,modified,10,0,src/renderer/renderer.js,high,0
Windows,66,6,35,added,35,0,appveyor.yml,medium,0
Windows,66,6,14,modified,7,7,tool.cpp,high,0
Windows,59,2,8,modified,7,1,.gitignore,low,0
Windows,59,2,19,added,19,0,CMakeLists.txt,low,0
Windows,59,2,3,added,3,0,clearcmakebuild.bat,medium,0
Windows,51,1,2,modified,1,1,README.md,low,0
Windows,20,4,7,modified,6,1,.gitignore,low,0
Windows,20,4,14,modified,12,2,README.md,low,0
Windows,20,4,195,modified,120,75,tool.cpp,high,0
Windows,19,1,4,modified,2,2,README.md,low,0
Windows,19,1,62,modified,27,35,tool.cpp,high,0
Windows,18,3,8,modified,4,4,README.md,low,0
Windows,18,3,84,modified,58,26,tool.cpp,high,0
Windows,17,1,8,modified,4,4,README.md,low,0
Windows,17,1,66,modified,63,3,tool.cpp,high,0
Windows,16,1,4,modified,2,2,README.md,low,0
Windows,16,1,5,modified,3,2,object-runwithcode/choose.cpp,high,0
Windows,16,1,10,added,10,0,object-runwithcode/choose.exe.manifest,medium,0
Windows,16,1,1,added,1,0,object-runwithcode/choose.rc,low,0
Windows,16,1,4,added,4,0,object-runwithcode/g++make.bat,medium,0
Windows,15,6,49,modified,11,38,README.md,low,0
Windows,15,6,1,removed,0,1,VERSION,NaN,0
Windows,15,6,17,modified,17,0,documents.md,low,0
Windows,15,6,4,modified,3,1,hander/pipedebug.hpp,NaN,0
Windows,15,6,8,modified,4,4,hander/ptrerr.hpp,NaN,0
Windows,15,6,88,modified,71,17,object-runwithcode/choose.cpp,high,0
Windows,15,6,119,modified,86,33,tool.cpp,high,0
Windows,14,0,4,modified,1,3,README.md,low,0
Windows,13,1,2,modified,1,1,README.md,low,0
Windows,13,1,144,modified,53,91,tool.cpp,high,0
Windows,12,3,3,modified,0,3,MSVS/VS2013/WinConsole.filters,medium,0
Windows,12,3,1,modified,0,1,MSVS/VS2013/WinConsole.vcxproj,medium,0
Windows,12,3,4,modified,2,2,README.md,low,0
Windows,12,3,15,modified,11,4,tool.cpp,high,0
Windows,11,5,10,modified,5,5,README.md,low,0
Windows,11,5,6,renamed,3,3,g++make.bat,medium,0
Windows,11,5,24,modified,17,7,hander/ptrerr.hpp,NaN,0
Windows,11,5,74,modified,37,37,tool.cpp,high,0
Windows,10,5,14,modified,10,4,README.md,low,0
Windows,10,5,2,modified,1,1,VERSION,NaN,0
Windows,10,5,6,modified,3,3,hander/diff.hpp,NaN,0
Windows,10,5,3,modified,2,1,hander/ptrerr.hpp,NaN,0
Windows,10,5,41,added,41,0,object-runwithcode/choose.cpp,high,0
Windows,10,5,197,modified,112,85,tool.cpp,high,0
Windows,9,2,241,modified,158,83,hander/ptrerr.hpp,NaN,0
Windows,9,2,4,modified,2,2,tool.cpp,high,0
Windows,8,1,115,modified,58,57,MSVS/VS2013/WinConsole.vcxproj,medium,0
Windows,8,1,6,modified,3,3,README.md,low,0
Windows,8,1,12,modified,5,7,tool.cpp,high,0
Windows,7,3,62,modified,34,28,MSVS/VS2013/WinConsole.sln,low,0
Windows,7,3,545,modified,321,224,MSVS/VS2013/WinConsole.vcxproj,medium,0
Windows,7,3,12,modified,9,3,tool.cpp,high,0
Windows,6,2,2,modified,1,1,README.md,low,0
Windows,6,2,2,modified,1,1,VERSION,NaN,0
Windows,6,2,51,modified,42,9,tool.cpp,high,0
Windows,5,1,2,modified,1,1,README.md,low,0
Windows,5,1,2,modified,2,0,hander/download.hpp,NaN,0
Windows,5,1,17,modified,15,2,tool.cpp,high,0
Windows,4,9,10,modified,5,5,MSVS/VS2013/WinConsole.vcxproj,medium,0
Windows,4,9,4,modified,2,2,README.md,low,0
Windows,4,9,1,added,1,0,VERSION,NaN,0
Windows,4,9,2,modified,1,1,hander/pipedebug.hpp,NaN,0
Windows,4,9,2,modified,0,2,hander/ptrerr.hpp,NaN,0
Windows,4,9,4,modified,4,0,tool.cpp,high,0
Windows,2,2,6,modified,3,3,README.md,low,0
Windows,2,2,28,modified,15,13,tool.cpp,high,0
Windows,1,0,4,modified,2,2,README.md,low,0
Windows,1,0,17,modified,9,8,tool.cpp,high,0
windows,581,1,2,modified,1,1,resources/share.rb,high,0
windows,579,1,2,modified,1,1,resources/feature_dism.rb,high,0
windows,574,1,464,modified,0,464,README.md,low,0
windows,574,1,9,modified,0,9,kitchen.appveyor.yml,medium,0
windows,574,1,22,modified,0,22,kitchen.yml,medium,0
windows,573,3,18,modified,7,11,kitchen.appveyor.yml,medium,0
windows,573,3,3,modified,1,2,kitchen.yml,medium,0
windows,573,3,29,modified,5,24,resources/certificate.rb,high,0
windows,572,1,2,modified,1,1,Gemfile,NaN,0
windows,572,1,8,modified,6,2,kitchen.appveyor.yml,medium,0
windows,572,1,4,modified,2,2,kitchen.yml,medium,0
windows,568,1,4,modified,1,3,README.md,low,0
windows,568,1,2,modified,1,1,metadata.rb,high,0
windows,568,1,56,removed,0,56,resources/path.rb,high,0
windows,568,1,396,removed,0,396,resources/task.rb,high,0
windows,567,2,10,modified,10,0,README.md,low,0
windows,567,2,7,modified,5,2,kitchen.appveyor.yml,medium,0
windows,567,2,4,modified,2,2,kitchen.yml,medium,0
windows,567,2,16,modified,15,1,resources/user_privilege.rb,high,0
windows,567,2,21,modified,20,1,test/cookbooks/test/recipes/user_privilege.rb,high,0
windows,559,0,2,modified,1,1,resources/share.rb,high,0
windows,558,3,1,modified,1,0,Gemfile,NaN,0
windows,558,3,29,modified,29,0,libraries/windows_helper.rb,high,0
windows,558,3,1,modified,1,0,metadata.rb,high,0
windows,558,3,135,modified,97,38,resources/certificate.rb,high,0
windows,558,3,1,modified,1,0,spec/spec_helper.rb,high,0
windows,558,3,0,modified,0,0,test/cookbooks/test/files/Asimov.otf,NaN,0
windows,558,3,21,added,21,0,test/cookbooks/test/files/GlobalSignRootCA.pem,NaN,0
windows,558,3,48,modified,24,24,test/cookbooks/test/files/base64-cert2.cer,NaN,0
windows,558,3,0,added,0,0,test/cookbooks/test/files/test_cert.crt,NaN,0
windows,558,3,0,added,0,0,test/cookbooks/test/files/test_der.der,NaN,0
windows,558,3,22,added,22,0,test/cookbooks/test/files/test_p7b.p7b,NaN,0
windows,558,3,159,modified,141,18,test/cookbooks/test/recipes/certificate.rb,high,0
windows,555,1,6,modified,3,3,resources/zipfile.rb,high,0
windows,552,2,1,modified,1,0,Gemfile,NaN,1
windows,552,2,29,modified,29,0,libraries/windows_helper.rb,high,1
windows,552,2,1,modified,1,0,metadata.rb,high,1
windows,552,2,63,modified,24,39,resources/certificate.rb,high,1
windows,552,2,1,modified,1,0,spec/spec_helper.rb,high,1
windows,552,2,0,modified,0,0,test/cookbooks/test/files/Asimov.otf,NaN,1
windows,552,2,21,added,21,0,test/cookbooks/test/files/GlobalSignRootCA.pem,NaN,1
windows,552,2,48,modified,24,24,test/cookbooks/test/files/base64-cert2.cer,NaN,1
windows,552,2,0,added,0,0,test/cookbooks/test/files/test_cert.crt,NaN,1
windows,552,2,0,added,0,0,test/cookbooks/test/files/test_der.der,NaN,1
windows,552,2,22,added,22,0,test/cookbooks/test/files/test_p7b.p7b,NaN,1
windows,552,2,84,modified,66,18,test/cookbooks/test/recipes/certificate.rb,high,1
windows,548,8,77,added,77,0,libraries/feature_cache_dism.rb,high,0
windows,548,8,71,added,71,0,libraries/feature_cache_ps.rb,high,0
windows,548,8,103,modified,33,70,resources/feature_dism.rb,high,0
windows,548,8,96,modified,28,68,resources/feature_powershell.rb,high,0
windows,548,8,3,modified,1,2,test/cookbooks/test/recipes/feature.rb,high,0
windows,544,27,24,modified,16,8,README.md,low,0
windows,544,27,376,modified,193,183,resources/share.rb,high,0
windows,536,1,10,modified,5,5,README.md,low,0
windows,533,1,42,modified,40,2,CHANGELOG.md,low,0
windows,528,4,4,modified,4,0,.kitchen.yml,medium,0
windows,527,1,9,modified,1,8,libraries/powershell_helper.rb,high,1
windows,525,2,5,modified,4,1,README.md,low,0
windows,523,1,54,modified,0,54,README.md,low,0
windows,523,1,586,removed,0,586,libraries/matchers.rb,high,0
windows,522,0,4,modified,2,2,resources/printer_port.rb,high,0
windows,520,1,2,modified,1,1,resources/certificate.rb,high,1
windows,518,2,3,modified,3,0,.kitchen.yml,medium,0
windows,518,2,73,modified,73,0,README.md,low,0
windows,514,5,7,modified,7,0,.rubocop.yml,medium,1
windows,503,1,29,modified,27,2,README.md,low,0
windows,503,1,2,modified,1,1,resources/certificate.rb,high,2
windows,503,1,2,modified,1,1,resources/certificate_binding.rb,high,0
windows,502,2,3,modified,2,1,resources/zipfile.rb,high,0
windows,500,1,11,modified,5,6,resources/font.rb,high,0
windows,499,1,6,modified,5,1,README.md,low,0
windows,499,1,11,modified,10,1,resources/font.rb,high,0
windows,496,2,11,modified,11,0,README.md,low,0
windows,495,2,6,modified,4,2,README.md,low,0
windows,495,2,5,modified,4,1,resources/feature.rb,high,1
windows,495,2,7,modified,4,3,resources/feature_dism.rb,high,1
windows,495,2,13,modified,7,6,resources/feature_powershell.rb,high,2
windows,495,2,8,modified,4,4,resources/feature_servermanagercmd.rb,high,0
windows,494,1,4,modified,2,2,README.md,low,0
windows,491,1,4,modified,3,1,resources/share.rb,high,0
windows,488,2,3,modified,0,3,.kitchen.appveyor.yml,medium,1
windows,488,2,3,modified,3,0,appveyor.yml,medium,1
windows,486,0,6,modified,3,3,README.md,low,0
windows,483,1,4,modified,4,0,README.md,low,1
windows,483,1,1130,modified,1107,23,resources/certificate.rb,high,3
windows,471,1,18,modified,18,0,README.md,low,1
windows,458,1,4,modified,4,0,CHANGELOG.md,low,0
windows,458,1,2,modified,1,1,metadata.rb,high,1
windows,457,1,2,modified,1,1,resources/task.rb,high,2
windows,457,1,15,modified,15,0,test/cookbooks/test/recipes/tasks.rb,high,0
windows,456,1,2,modified,1,1,resources/feature_dism.rb,high,1
windows,455,2,2,modified,1,1,resources/feature_dism.rb,high,2
windows,452,1,22,modified,0,22,libraries/windows_helper.rb,high,1
windows,452,1,38,modified,31,7,resources/zipfile.rb,high,0
windows,452,1,5,modified,5,0,test/cookbooks/test/recipes/zipfile.rb,high,0
windows,450,0,2,modified,1,1,CHANGELOG.md,low,0
windows,449,1,112,modified,61,51,resources/share.rb,high,0
windows,445,3,178,removed,0,178,providers/certificate.rb,high,0
windows,445,3,138,removed,0,138,providers/certificate_binding.rb,high,0
windows,445,3,114,removed,0,114,providers/http_acl.rb,high,0
windows,445,3,362,removed,0,362,providers/task.rb,high,0
windows,445,3,154,modified,146,8,resources/certificate.rb,high,3
windows,445,3,115,modified,106,9,resources/certificate_binding.rb,high,0
windows,445,3,94,modified,88,6,resources/http_acl.rb,high,0
windows,445,3,385,modified,357,28,resources/task.rb,high,2
windows,445,3,15,modified,9,6,test/cookbooks/test/recipes/tasks.rb,high,0
windows,444,1,5,modified,4,1,recipes/default.rb,high,1
windows,443,1,2,modified,0,2,providers/task.rb,high,1
windows,442,1,27,removed,0,27,.travis.yml,medium,0
windows,442,1,7,modified,3,4,README.md,low,1
windows,441,1,2,modified,1,1,resources/auto_run.rb,high,0
windows,441,1,4,modified,2,2,resources/feature.rb,high,1
windows,441,1,4,modified,2,2,resources/feature_dism.rb,high,2
windows,441,1,2,modified,1,1,resources/feature_powershell.rb,high,2
windows,441,1,2,modified,1,1,resources/feature_servermanagercmd.rb,high,0
windows,441,1,2,modified,1,1,resources/font.rb,high,0
windows,441,1,6,modified,3,3,resources/pagefile.rb,high,0
windows,441,1,2,modified,1,1,resources/path.rb,high,0
windows,441,1,4,modified,2,2,resources/share.rb,high,0
windows,441,1,4,modified,2,2,resources/zipfile.rb,high,0
windows,440,3,1,modified,1,0,.kitchen.appveyor.yml,medium,1
windows,440,3,8,modified,8,0,README.md,low,1
windows,440,3,3,modified,2,1,test/cookbooks/test/recipes/feature.rb,high,1
windows,439,1,100,removed,0,100,providers/printer.rb,high,0
windows,439,1,100,removed,0,100,providers/printer_port.rb,high,0
windows,439,1,92,modified,79,13,resources/printer.rb,high,0
windows,439,1,84,modified,75,9,resources/printer_port.rb,high,0
windows,438,1,35,modified,35,0,libraries/matchers.rb,high,0
windows,437,1,60,removed,0,60,providers/shortcut.rb,high,0
windows,437,1,39,modified,31,8,resources/shortcut.rb,high,0
windows,436,1,199,removed,0,199,providers/share.rb,high,0
windows,436,1,267,modified,258,9,resources/share.rb,high,0
windows,436,1,2,modified,2,0,test/cookbooks/test/recipes/share.rb,high,0
windows,436,1,102,modified,51,51,test/integration/share/pester/minimal.share.Tests.ps1,high,0
windows,435,1,1,modified,0,1,resources/shortcut.rb,high,0
windows,434,1,7,modified,6,1,resources/feature_powershell.rb,high,2
windows,433,21,1,added,1,0,.delivery/project.toml,medium,0
windows,433,21,1,modified,1,0,.foodcritic,NaN,0
windows,433,21,3,modified,3,0,.kitchen.appveyor.yml,medium,1
windows,433,21,13,modified,11,2,.kitchen.yml,medium,0
windows,433,21,6,modified,3,3,.travis.yml,medium,0
windows,433,21,1,modified,0,1,Gemfile,NaN,1
windows,433,21,34,modified,24,10,README.md,low,1
windows,433,21,69,removed,0,69,Rakefile,NaN,0
windows,433,21,2,modified,1,1,appveyor.yml,medium,1
windows,433,21,2,modified,1,1,attributes/default.rb,high,0
windows,433,21,0,renamed,0,0,files/dism_features.rb,high,0
windows,433,21,57,removed,0,57,libraries/feature_base.rb,high,0
windows,433,21,2,modified,1,1,libraries/powershell_helper.rb,high,1
windows,433,21,6,modified,3,3,libraries/registry_helper.rb,high,0
windows,433,21,2,modified,1,1,libraries/version.rb,high,0
windows,433,21,2,modified,1,1,libraries/version_helper.rb,high,0
windows,433,21,2,modified,1,1,libraries/windows_helper.rb,high,1
windows,433,21,4,modified,2,2,libraries/windows_privileged.rb,high,0
windows,433,21,2,modified,1,1,libraries/wmi_helper.rb,high,0
windows,433,21,2,modified,1,1,metadata.rb,high,1
windows,433,21,47,removed,0,47,providers/auto_run.rb,high,0
windows,433,21,2,modified,1,1,providers/certificate.rb,high,0
windows,433,21,2,modified,1,1,providers/certificate_binding.rb,high,0
windows,433,21,93,removed,0,93,providers/feature_dism.rb,high,0
windows,433,21,49,removed,0,49,providers/feature_powershell.rb,high,0
windows,433,21,63,removed,0,63,providers/feature_servermanagercmd.rb,high,0
windows,433,21,83,removed,0,83,providers/font.rb,high,0
windows,433,21,2,modified,1,1,providers/http_acl.rb,high,0
windows,433,21,151,removed,0,151,providers/pagefile.rb,high,0
windows,433,21,53,removed,0,53,providers/path.rb,high,0
windows,432,2,2,modified,1,1,providers/feature_powershell.rb,high,0
windows,432,2,6,modified,3,3,providers/feature_servermanagercmd.rb,high,0
windows,431,1,8,modified,5,3,.travis.yml,medium,0
windows,430,2,35,modified,17,18,README.md,low,1
windows,430,2,6,modified,6,0,libraries/windows_helper.rb,high,1
windows,430,2,6,modified,3,3,providers/feature_dism.rb,high,0
windows,430,2,14,modified,7,7,providers/feature_powershell.rb,high,0
windows,430,2,4,modified,2,2,providers/feature_servermanagercmd.rb,high,0
windows,430,2,2,modified,1,1,resources/feature.rb,high,1
windows,430,2,7,modified,6,1,test/cookbooks/test/recipes/feature.rb,high,1
windows,430,2,12,modified,8,4,test/integration/feature/pester/minimal.package.Tests.ps1,high,0
windows,429,2,4,modified,2,2,providers/feature_powershell.rb,high,0
windows,429,2,2,modified,1,1,test/integration/feature/pester/minimal.package.Tests.ps1,high,0
windows,427,3,3,modified,0,3,.kitchen.appveyor.yml,medium,1
windows,427,3,41,removed,0,41,.kitchen.cloud.yml,medium,0
windows,427,3,43,modified,2,41,.rubocop.yml,medium,1
windows,427,3,2,modified,1,1,.travis.yml,medium,0
windows,427,3,119,modified,2,117,README.md,low,1
windows,427,3,1,modified,0,1,appveyor.yml,medium,1
windows,427,3,58,modified,0,58,libraries/matchers.rb,high,0
windows,427,3,94,removed,0,94,libraries/powershell_out.rb,high,0
windows,427,3,242,removed,0,242,libraries/windows_package.rb,high,0
windows,427,3,2,modified,1,1,metadata.rb,high,1
windows,427,3,2,modified,0,2,test/cookbooks/test/recipes/autorun.rb,high,0
windows,427,3,2,modified,0,2,test/cookbooks/test/recipes/certificate.rb,high,2
windows,427,3,2,modified,0,2,test/cookbooks/test/recipes/font.rb,high,0
windows,427,3,2,modified,0,2,test/cookbooks/test/recipes/http_acl.rb,high,0
windows,427,3,6,removed,0,6,test/cookbooks/test/recipes/package.rb,high,0
windows,427,3,2,modified,0,2,test/cookbooks/test/recipes/path.rb,high,0
windows,427,3,2,modified,0,2,test/cookbooks/test/recipes/tasks.rb,high,0
windows,427,3,11,removed,0,11,test/integration/package/pester/minimal.package.Tests.ps1,high,0
windows,425,0,4,modified,2,2,providers/path.rb,high,0
windows,425,0,6,modified,6,0,test/cookbooks/test/recipes/path.rb,high,0
windows,425,0,10,modified,7,3,test/integration/path/pester/minimal.path.Tests.ps1,high,0
windows,423,2,2,modified,1,1,README.md,low,1
windows,423,2,3,modified,2,1,providers/feature_powershell.rb,high,0
windows,423,2,6,modified,6,0,test/cookbooks/test/recipes/feature.rb,high,1
windows,423,2,4,modified,4,0,test/integration/feature/pester/minimal.package.Tests.ps1,high,0
windows,421,1,12,modified,7,5,Rakefile,NaN,1
windows,421,1,2,modified,1,1,libraries/powershell_out.rb,high,1
windows,421,1,6,modified,3,3,libraries/registry_helper.rb,high,1
windows,421,1,6,modified,3,3,libraries/version.rb,high,1
windows,421,1,2,modified,1,1,libraries/windows_helper.rb,high,2
windows,421,1,4,modified,2,2,providers/auto_run.rb,high,1
windows,421,1,2,modified,1,1,providers/certificate_binding.rb,high,1
windows,421,1,8,modified,4,4,providers/share.rb,high,1
windows,421,1,4,modified,2,2,resources/printer_port.rb,high,1
windows,421,1,4,modified,2,2,resources/share.rb,high,1
windows,418,4,18,modified,9,9,libraries/version_helper.rb,high,0
windows,418,4,12,modified,10,2,providers/http_acl.rb,high,0
windows,418,4,4,modified,2,2,providers/share.rb,high,1
windows,418,4,18,removed,0,18,spec/default_spec.rb,high,0
windows,417,1,2,modified,0,2,.travis.yml,medium,0
windows,415,1,18,modified,9,9,libraries/version_helper.rb,high,0
windows,414,1,1,modified,1,0,resources/feature.rb,high,1
windows,413,1,4,modified,0,4,README.md,low,1
windows,413,1,23,modified,1,22,recipes/default.rb,high,1
windows,412,1,5,modified,5,0,providers/feature_dism.rb,high,1
windows,412,1,3,modified,3,0,providers/feature_powershell.rb,high,1
windows,412,1,5,modified,5,0,providers/feature_servermanagercmd.rb,high,1
windows,412,1,25,renamed,6,19,resources/feature_dism.rb,high,3
windows,412,1,32,added,32,0,resources/feature_powershell.rb,high,3
windows,412,1,34,added,34,0,resources/feature_servermanagercmd.rb,high,1
windows,411,1,13,modified,13,0,providers/feature_dism.rb,high,1
windows,411,1,2,modified,0,2,test/cookbooks/test/recipes/feature.rb,high,1
windows,408,1,10,modified,9,1,README.md,low,1
windows,408,1,35,modified,24,11,providers/http_acl.rb,high,0
windows,408,1,1,modified,1,0,resources/http_acl.rb,high,0
windows,408,1,17,added,17,0,test/cookbooks/minimal/recipes/http_acl.rb,high,0
windows,405,1,7,modified,5,2,libraries/powershell_out.rb,high,1
windows,405,1,2,modified,1,1,libraries/windows_package.rb,high,0
windows,403,1,2,modified,1,1,metadata.rb,high,1
windows,402,2,6,modified,6,0,CHANGELOG.md,low,0
windows,402,2,45,added,45,0,files/default/dism_features.rb,high,0
windows,402,2,1,modified,1,0,metadata.rb,high,1
windows,402,2,26,modified,17,9,providers/feature_dism.rb,high,1
windows,402,2,6,modified,6,0,recipes/default.rb,high,1
windows,401,2,2,modified,1,1,resources/certificate.rb,high,3
Windows-universal-samples,987,1,6,modified,3,3,Samples/BackgroundMediaPlayback/cs/ViewModels/MediaItemViewModel.cs,high,0
Windows-universal-samples,985,1,2,modified,1,1,LICENSE,low,0
Windows-universal-samples,984,5,95,modified,51,44,Samples/BackgroundTransfer/cpp/Tasks/CompletionGroupTask.cpp,high,1
Windows-universal-samples,984,5,8,modified,4,4,Samples/BackgroundTransfer/cpp/Tasks/CompletionGroupTask.h,high,1
Windows-universal-samples,984,5,33,modified,24,9,Samples/BackgroundTransfer/cs/Tasks/CompletionGroupTask.cs,high,1
Windows-universal-samples,984,5,4,modified,4,0,Samples/XamlUIBasics/README.md,low,1
Windows-universal-samples,984,5,2,modified,1,1,Samples/XamlUIBasics/cs/AppUIBasics/AllControlsPage.xaml.cs,high,1
Windows-universal-samples,984,5,4,modified,3,1,Samples/XamlUIBasics/cs/AppUIBasics/App.xaml,medium,1
Windows-universal-samples,984,5,18,modified,15,3,Samples/XamlUIBasics/cs/AppUIBasics/App.xaml.cs,high,1
Windows-universal-samples,984,5,256,modified,252,4,Samples/XamlUIBasics/cs/AppUIBasics/AppUIBasics.csproj,low,1
Windows-universal-samples,984,5,40,modified,20,20,Samples/XamlUIBasics/cs/AppUIBasics/AppUIBasics.sln,low,1
Windows-universal-samples,984,5,0,added,0,0,Samples/XamlUIBasics/cs/AppUIBasics/Assets/Animations.png,low,1
Windows-universal-samples,984,5,0,added,0,0,Samples/XamlUIBasics/cs/AppUIBasics/Assets/CommandBarFlyout.png,low,1
Windows-universal-samples,984,5,0,added,0,0,Samples/XamlUIBasics/cs/AppUIBasics/Assets/CompactSizing.png,low,1
Windows-universal-samples,984,5,0,added,0,0,Samples/XamlUIBasics/cs/AppUIBasics/Assets/ConnectedAnimations.png,low,1
Windows-universal-samples,984,5,768,added,768,0,Samples/XamlUIBasics/cs/AppUIBasics/Assets/Contacts.txt,low,1
Windows-universal-samples,984,5,0,added,0,0,Samples/XamlUIBasics/cs/AppUIBasics/Assets/DropdownButton.png,low,1
Windows-universal-samples,984,5,0,added,0,0,Samples/XamlUIBasics/cs/AppUIBasics/Assets/EasingFunctions.png,low,1
Windows-universal-samples,984,5,0,added,0,0,Samples/XamlUIBasics/cs/AppUIBasics/Assets/MenuBar.png,low,1
Windows-universal-samples,984,5,0,added,0,0,Samples/XamlUIBasics/cs/AppUIBasics/Assets/NavigationViewItemIcons/ObjectQuickAnimation.png,low,1
Windows-universal-samples,984,5,0,added,0,0,Samples/XamlUIBasics/cs/AppUIBasics/Assets/SplitButton.png,low,1
Windows-universal-samples,984,5,0,added,0,0,Samples/XamlUIBasics/cs/AppUIBasics/Assets/StoryboardAnimation.png,low,1
Windows-universal-samples,984,5,0,added,0,0,Samples/XamlUIBasics/cs/AppUIBasics/Assets/TimingDuration.png,low,1
Windows-universal-samples,984,5,0,added,0,0,Samples/XamlUIBasics/cs/AppUIBasics/Assets/ToggleSplitButton.png,low,1
Windows-universal-samples,984,5,0,added,0,0,Samples/XamlUIBasics/cs/AppUIBasics/Assets/Transitions.png,low,1
Windows-universal-samples,984,5,0,added,0,0,Samples/XamlUIBasics/cs/AppUIBasics/Assets/blank.png,low,1
Windows-universal-samples,984,5,0,added,0,0,Samples/XamlUIBasics/cs/AppUIBasics/Assets/file.png,low,1
Windows-universal-samples,984,5,0,added,0,0,Samples/XamlUIBasics/cs/AppUIBasics/Assets/folder.png,low,1
Windows-universal-samples,984,5,0,added,0,0,Samples/XamlUIBasics/cs/AppUIBasics/Assets/new.png,low,1
Windows-universal-samples,984,5,0,added,0,0,Samples/XamlUIBasics/cs/AppUIBasics/Assets/preview.png,low,1
Windows-universal-samples,984,5,0,added,0,0,Samples/XamlUIBasics/cs/AppUIBasics/Assets/updated.png,low,1
Windows-universal-samples,984,5,276,added,276,0,Samples/XamlUIBasics/cs/AppUIBasics/Common/ActivityFeedLayout.cs,high,1
Windows-universal-samples,965,1,3,modified,3,0,Samples/BarcodeScanner/cs/Scenario1_BasicFunctionality.xaml.cs,high,0
Windows-universal-samples,959,1,2,modified,1,1,Samples/Printing/cpp/PageToPrint.xaml,medium,1
Windows-universal-samples,959,1,2,modified,1,1,Samples/Printing/cs/PageToPrint.xaml,medium,1
Windows-universal-samples,951,1,4,modified,4,0,Samples/XamlUIBasics/README.md,low,2
Windows-universal-samples,951,1,2,modified,1,1,Samples/XamlUIBasics/cs/AppUIBasics/AllControlsPage.xaml.cs,high,2
Windows-universal-samples,951,1,4,modified,3,1,Samples/XamlUIBasics/cs/AppUIBasics/App.xaml,medium,2
Windows-universal-samples,951,1,25,modified,23,2,Samples/XamlUIBasics/cs/AppUIBasics/App.xaml.cs,high,2
Windows-universal-samples,951,1,216,modified,213,3,Samples/XamlUIBasics/cs/AppUIBasics/AppUIBasics.csproj,low,2
Windows-universal-samples,951,1,40,modified,20,20,Samples/XamlUIBasics/cs/AppUIBasics/AppUIBasics.sln,low,2
Windows-universal-samples,951,1,0,added,0,0,Samples/XamlUIBasics/cs/AppUIBasics/Assets/Animations.png,low,2
Windows-universal-samples,951,1,0,added,0,0,Samples/XamlUIBasics/cs/AppUIBasics/Assets/CommandBarFlyout.png,low,2
Windows-universal-samples,951,1,0,added,0,0,Samples/XamlUIBasics/cs/AppUIBasics/Assets/ConnectedAnimations.png,low,2
Windows-universal-samples,951,1,0,added,0,0,Samples/XamlUIBasics/cs/AppUIBasics/Assets/DropdownButton.png,low,2
Windows-universal-samples,951,1,0,added,0,0,Samples/XamlUIBasics/cs/AppUIBasics/Assets/EasingFunctions.png,low,2
Windows-universal-samples,951,1,0,added,0,0,Samples/XamlUIBasics/cs/AppUIBasics/Assets/MenuBar.png,low,2
Windows-universal-samples,951,1,0,added,0,0,Samples/XamlUIBasics/cs/AppUIBasics/Assets/NavigationViewItemIcons/ObjectQuickAnimation.png,low,2
Windows-universal-samples,951,1,0,added,0,0,Samples/XamlUIBasics/cs/AppUIBasics/Assets/Sound.png,low,1
Windows-universal-samples,951,1,0,added,0,0,Samples/XamlUIBasics/cs/AppUIBasics/Assets/SplitButton.png,low,2
Windows-universal-samples,951,1,0,added,0,0,Samples/XamlUIBasics/cs/AppUIBasics/Assets/StoryboardAnimation.png,low,2
Windows-universal-samples,951,1,0,added,0,0,Samples/XamlUIBasics/cs/AppUIBasics/Assets/TimingDuration.png,low,2
Windows-universal-samples,951,1,0,added,0,0,Samples/XamlUIBasics/cs/AppUIBasics/Assets/ToggleSplitButton.png,low,2
Windows-universal-samples,951,1,0,added,0,0,Samples/XamlUIBasics/cs/AppUIBasics/Assets/Transitions.png,low,2
Windows-universal-samples,951,1,0,added,0,0,Samples/XamlUIBasics/cs/AppUIBasics/Assets/blank.png,low,2
Windows-universal-samples,951,1,0,added,0,0,Samples/XamlUIBasics/cs/AppUIBasics/Assets/file.png,low,2
Windows-universal-samples,951,1,0,added,0,0,Samples/XamlUIBasics/cs/AppUIBasics/Assets/folder.png,low,2
Windows-universal-samples,951,1,0,added,0,0,Samples/XamlUIBasics/cs/AppUIBasics/Assets/new.png,low,2
Windows-universal-samples,951,1,0,added,0,0,Samples/XamlUIBasics/cs/AppUIBasics/Assets/preview.png,low,2
Windows-universal-samples,951,1,0,added,0,0,Samples/XamlUIBasics/cs/AppUIBasics/Assets/updated.png,low,2
Windows-universal-samples,951,1,276,added,276,0,Samples/XamlUIBasics/cs/AppUIBasics/Common/ActivityFeedLayout.cs,high,2
Windows-universal-samples,951,1,23,added,23,0,Samples/XamlUIBasics/cs/AppUIBasics/Common/Category.cs,high,1
Windows-universal-samples,951,1,5,modified,5,0,Samples/XamlUIBasics/cs/AppUIBasics/Common/ComboBoxItemToStringConverter.cs,high,1
Windows-universal-samples,951,1,36,added,36,0,Samples/XamlUIBasics/cs/AppUIBasics/Common/MenuItemTemplateSelector.cs,high,1
Windows-universal-samples,951,1,10,modified,6,4,Samples/XamlUIBasics/cs/AppUIBasics/Common/NavigationHelper.cs,high,1
Windows-universal-samples,950,1,4,modified,2,2,SharedContent/cs/Default.rd.xml,medium,0
Windows-universal-samples,949,2,21,removed,0,21,LICENSE,low,0
Windows-universal-samples,949,2,22,added,22,0,LICENSE.txt,low,0
Windows-universal-samples,946,1,4,modified,4,0,Samples/XamlUIBasics/README.md,low,3
Windows-universal-samples,946,1,2,modified,1,1,Samples/XamlUIBasics/cs/AppUIBasics/AllControlsPage.xaml.cs,high,3
Windows-universal-samples,946,1,4,modified,3,1,Samples/XamlUIBasics/cs/AppUIBasics/App.xaml,medium,3
Windows-universal-samples,946,1,25,modified,23,2,Samples/XamlUIBasics/cs/AppUIBasics/App.xaml.cs,high,3
Windows-universal-samples,946,1,216,modified,213,3,Samples/XamlUIBasics/cs/AppUIBasics/AppUIBasics.csproj,low,3
Windows-universal-samples,946,1,40,modified,20,20,Samples/XamlUIBasics/cs/AppUIBasics/AppUIBasics.sln,low,3
Windows-universal-samples,946,1,0,added,0,0,Samples/XamlUIBasics/cs/AppUIBasics/Assets/Animations.png,low,3
Windows-universal-samples,946,1,0,added,0,0,Samples/XamlUIBasics/cs/AppUIBasics/Assets/CommandBarFlyout.png,low,3
Windows-universal-samples,946,1,0,added,0,0,Samples/XamlUIBasics/cs/AppUIBasics/Assets/ConnectedAnimations.png,low,3
Windows-universal-samples,946,1,0,added,0,0,Samples/XamlUIBasics/cs/AppUIBasics/Assets/DropdownButton.png,low,3
Windows-universal-samples,946,1,0,added,0,0,Samples/XamlUIBasics/cs/AppUIBasics/Assets/EasingFunctions.png,low,3
Windows-universal-samples,946,1,0,added,0,0,Samples/XamlUIBasics/cs/AppUIBasics/Assets/MenuBar.png,low,3
Windows-universal-samples,946,1,0,added,0,0,Samples/XamlUIBasics/cs/AppUIBasics/Assets/NavigationViewItemIcons/ObjectQuickAnimation.png,low,3
Windows-universal-samples,946,1,0,added,0,0,Samples/XamlUIBasics/cs/AppUIBasics/Assets/Sound.png,low,2
Windows-universal-samples,946,1,0,added,0,0,Samples/XamlUIBasics/cs/AppUIBasics/Assets/SplitButton.png,low,3
Windows-universal-samples,946,1,0,added,0,0,Samples/XamlUIBasics/cs/AppUIBasics/Assets/StoryboardAnimation.png,low,3
Windows-universal-samples,946,1,0,added,0,0,Samples/XamlUIBasics/cs/AppUIBasics/Assets/TimingDuration.png,low,3
Windows-universal-samples,946,1,0,added,0,0,Samples/XamlUIBasics/cs/AppUIBasics/Assets/ToggleSplitButton.png,low,3
Windows-universal-samples,946,1,0,added,0,0,Samples/XamlUIBasics/cs/AppUIBasics/Assets/Transitions.png,low,3
Windows-universal-samples,946,1,0,added,0,0,Samples/XamlUIBasics/cs/AppUIBasics/Assets/blank.png,low,3
Windows-universal-samples,946,1,0,added,0,0,Samples/XamlUIBasics/cs/AppUIBasics/Assets/file.png,low,3
Windows-universal-samples,946,1,0,added,0,0,Samples/XamlUIBasics/cs/AppUIBasics/Assets/folder.png,low,3
Windows-universal-samples,946,1,0,added,0,0,Samples/XamlUIBasics/cs/AppUIBasics/Assets/new.png,low,3
Windows-universal-samples,946,1,0,added,0,0,Samples/XamlUIBasics/cs/AppUIBasics/Assets/preview.png,low,3
Windows-universal-samples,946,1,0,added,0,0,Samples/XamlUIBasics/cs/AppUIBasics/Assets/updated.png,low,3
Windows-universal-samples,946,1,276,added,276,0,Samples/XamlUIBasics/cs/AppUIBasics/Common/ActivityFeedLayout.cs,high,3
Windows-universal-samples,946,1,23,added,23,0,Samples/XamlUIBasics/cs/AppUIBasics/Common/Category.cs,high,2
Windows-universal-samples,946,1,5,modified,5,0,Samples/XamlUIBasics/cs/AppUIBasics/Common/ComboBoxItemToStringConverter.cs,high,2
Windows-universal-samples,946,1,36,added,36,0,Samples/XamlUIBasics/cs/AppUIBasics/Common/MenuItemTemplateSelector.cs,high,2
Windows-universal-samples,946,1,10,modified,6,4,Samples/XamlUIBasics/cs/AppUIBasics/Common/NavigationHelper.cs,high,2
Windows-universal-samples,942,4,12,modified,12,0,Samples/360VideoPlayback/cpp/360VideoPlayback.vcxproj,medium,0
Windows-universal-samples,942,4,11,modified,11,0,Samples/360VideoPlayback/cpp/Content/VideoRenderer.cpp,high,0
Windows-universal-samples,936,5,32,modified,12,20,README.md,low,1
Windows-universal-samples,936,5,16,added,16,0,Samples/360VideoPlayback/360-video-playback.yaml,medium,1
Windows-universal-samples,936,5,26,modified,13,13,Samples/360VideoPlayback/cpp/360VideoPlayback.sln,low,1
Windows-universal-samples,936,5,6,modified,3,3,Samples/360VideoPlayback/cpp/360VideoPlayback.vcxproj,medium,1
Windows-universal-samples,936,5,2,modified,1,1,Samples/360VideoPlayback/cpp/Package.appxmanifest,medium,1
Windows-universal-samples,936,5,6,modified,3,3,Samples/360VideoPlayback/cs/360VideoPlayback.csproj,low,1
Windows-universal-samples,936,5,26,modified,13,13,Samples/360VideoPlayback/cs/360VideoPlayback.sln,low,1
Windows-universal-samples,936,5,2,modified,1,1,Samples/360VideoPlayback/cs/Package.appxmanifest,medium,1
Windows-universal-samples,936,5,11,modified,8,3,Samples/3DPrinting/3d-printing.yaml,medium,1
Windows-universal-samples,936,5,6,modified,3,3,Samples/3DPrinting/cs/3DPrinting.csproj,low,1
Windows-universal-samples,936,5,38,modified,19,19,Samples/3DPrinting/cs/3DPrinting.sln,low,1
Windows-universal-samples,936,5,2,modified,1,1,Samples/3DPrinting/cs/Package.appxmanifest,medium,1
Windows-universal-samples,936,5,3,modified,1,2,Samples/3DPrintingFromUnity/3d-printing-from-unity.yaml,medium,1
Windows-universal-samples,936,5,11,modified,8,3,Samples/Accelerometer/accelerometer.yaml,medium,1
Windows-universal-samples,936,5,38,modified,19,19,Samples/Accelerometer/cpp/Accelerometer.sln,low,1
Windows-universal-samples,936,5,6,modified,3,3,Samples/Accelerometer/cpp/Accelerometer.vcxproj,medium,1
Windows-universal-samples,936,5,2,modified,1,1,Samples/Accelerometer/cpp/Package.appxmanifest,medium,1
Windows-universal-samples,936,5,6,modified,3,3,Samples/Accelerometer/cs/Accelerometer.csproj,low,1
Windows-universal-samples,936,5,38,modified,19,19,Samples/Accelerometer/cs/Accelerometer.sln,low,1
Windows-universal-samples,936,5,2,modified,1,1,Samples/Accelerometer/cs/Package.appxmanifest,medium,1
Windows-universal-samples,936,5,9,modified,6,3,Samples/Accelerometer/js/Accelerometer.jsproj,high,1
Windows-universal-samples,936,5,50,modified,25,25,Samples/Accelerometer/js/Accelerometer.sln,low,1
Windows-universal-samples,936,5,4,modified,2,2,Samples/Accelerometer/js/Package.appxmanifest,medium,1
Windows-universal-samples,936,5,38,modified,19,19,Samples/Accelerometer/vb/Accelerometer.sln,low,1
Windows-universal-samples,936,5,6,modified,3,3,Samples/Accelerometer/vb/Accelerometer.vbproj,NaN,1
Windows-universal-samples,936,5,2,modified,1,1,Samples/Accelerometer/vb/Package.appxmanifest,medium,1
Windows-universal-samples,936,5,11,modified,8,3,Samples/ActivitySensor/activity-sensor.yaml,medium,1
Windows-universal-samples,936,5,70,modified,35,35,Samples/ActivitySensor/cpp/ActivitySensor.sln,low,1
Windows-universal-samples,936,5,6,modified,3,3,Samples/ActivitySensor/cpp/ActivitySensor.vcxproj,medium,1
Windows-universal-samples,936,5,2,modified,1,1,Samples/ActivitySensor/cpp/Package.appxmanifest,medium,1
Windows-universal-samples,931,12,2,modified,1,1,.gitignore,low,1
Windows-universal-samples,931,12,35,modified,21,14,README.md,low,2
Windows-universal-samples,931,12,26,modified,13,13,Samples/360VideoPlayback/cpp/360VideoPlayback.sln,low,2
Windows-universal-samples,931,12,6,modified,3,3,Samples/360VideoPlayback/cpp/360VideoPlayback.vcxproj,medium,2
Windows-universal-samples,931,12,21,modified,1,20,Samples/360VideoPlayback/cpp/Common/DeviceResources.cpp,high,1
Windows-universal-samples,931,12,2,modified,1,1,Samples/360VideoPlayback/cpp/Common/DirectXHelper.h,high,1
Windows-universal-samples,931,12,4,modified,2,2,Samples/360VideoPlayback/cpp/Package.appxmanifest,medium,2
Windows-universal-samples,931,12,6,modified,3,3,Samples/360VideoPlayback/cs/360VideoPlayback.csproj,low,2
Windows-universal-samples,931,12,26,modified,13,13,Samples/360VideoPlayback/cs/360VideoPlayback.sln,low,2
Windows-universal-samples,931,12,23,modified,2,21,Samples/360VideoPlayback/cs/Common/DeviceResources.cs,high,1
Windows-universal-samples,931,12,4,modified,2,2,Samples/360VideoPlayback/cs/Package.appxmanifest,medium,2
Windows-universal-samples,931,12,3,modified,2,1,Samples/360VideoPlayback/cs/ms.fxcompile.targets,low,1
Windows-universal-samples,931,12,10,added,10,0,Samples/3DPrinting/3d-printing.yaml,medium,2
Windows-universal-samples,931,12,6,modified,3,3,Samples/3DPrinting/cs/3DPrinting.csproj,low,2
Windows-universal-samples,931,12,38,modified,19,19,Samples/3DPrinting/cs/3DPrinting.sln,low,2
Windows-universal-samples,931,12,2,modified,1,1,Samples/3DPrinting/cs/Package.appxmanifest,medium,2
Windows-universal-samples,931,12,10,added,10,0,Samples/3DPrintingFromUnity/3d-printing-from-unity.yaml,medium,2
Windows-universal-samples,931,12,2,modified,1,1,Samples/3DPrintingFromUnity/README.md,low,1
Windows-universal-samples,931,12,13,added,13,0,Samples/Accelerometer/accelerometer.yaml,medium,2
Windows-universal-samples,931,12,38,modified,19,19,Samples/Accelerometer/cpp/Accelerometer.sln,low,2
Windows-universal-samples,931,12,6,modified,3,3,Samples/Accelerometer/cpp/Accelerometer.vcxproj,medium,2
Windows-universal-samples,931,12,2,modified,1,1,Samples/Accelerometer/cpp/Package.appxmanifest,medium,2
Windows-universal-samples,931,12,6,modified,3,3,Samples/Accelerometer/cs/Accelerometer.csproj,low,2
Windows-universal-samples,931,12,38,modified,19,19,Samples/Accelerometer/cs/Accelerometer.sln,low,2
Windows-universal-samples,931,12,2,modified,1,1,Samples/Accelerometer/cs/Package.appxmanifest,medium,2
Windows-universal-samples,931,12,2,modified,0,2,Samples/Accelerometer/cs/Scenario2_ShakeEvents.xaml.cs,high,1
Windows-universal-samples,931,12,6,modified,3,3,Samples/Accelerometer/js/Accelerometer.jsproj,high,2
Windows-universal-samples,931,12,50,modified,25,25,Samples/Accelerometer/js/Accelerometer.sln,low,2
Windows-universal-samples,931,12,2,modified,1,1,Samples/Accelerometer/js/Package.appxmanifest,medium,2
Windows-universal-samples,931,12,38,modified,19,19,Samples/Accelerometer/vb/Accelerometer.sln,low,2
Windows-universal-samples,921,1,4,modified,4,0,Samples/IoT-GPIO/cpp/Package.appxmanifest,medium,1
Windows-universal-samples,921,1,4,modified,4,0,Samples/IoT-GPIO/cs/Package.appxmanifest,medium,1
Windows-universal-samples,921,1,6,modified,5,1,Samples/IoT-GPIO/js/package.appxmanifest,medium,1
Windows-universal-samples,921,1,4,modified,4,0,Samples/IoT-I2C/cpp/Package.appxmanifest,medium,1
Windows-universal-samples,921,1,4,modified,4,0,Samples/IoT-I2C/cs/Package.appxmanifest,medium,1
Windows-universal-samples,921,1,6,modified,5,1,Samples/IoT-I2C/js/package.appxmanifest,medium,1
Windows-universal-samples,921,1,4,modified,4,0,Samples/IoT-SPI/cpp/Package.appxmanifest,medium,1
Windows-universal-samples,921,1,4,modified,4,0,Samples/IoT-SPI/cs/Package.appxmanifest,medium,1
Windows-universal-samples,921,1,6,modified,5,1,Samples/IoT-SPI/js/package.appxmanifest,medium,1
Windows-universal-samples,910,1,8,modified,4,4,Samples/XamlUIBasics/cs/AppUIBasics/ControlPages/MenuFlyoutPage.xaml,medium,0
Windows-universal-samples,905,1,13,modified,11,2,Samples/BluetoothLE/cs/DisplayHelpers.cs,high,0
Windows-universal-samples,898,1,2,modified,1,1,Samples/BluetoothAdvertisement/README.md,low,0
Windows-universal-samples,896,1,10,modified,0,10,Samples/BasicHologram/cppwinrt/BasicHologram.vcxproj,medium,0
Windows-universal-samples,896,1,1,modified,0,1,Samples/BasicHologram/cppwinrt/BasicHologram.vcxproj.filters,medium,0
Windows-universal-samples,896,1,4,modified,2,2,Samples/BasicHologram/cppwinrt/BasicHologramMain.cpp,high,0
Windows-universal-samples,896,1,2,modified,1,1,Samples/BasicHologram/cppwinrt/Common/DeviceResources.cpp,high,0
Windows-universal-samples,896,1,2,modified,1,1,Samples/BasicHologram/cppwinrt/Common/DirectXHelper.h,high,0
Windows-universal-samples,896,1,4,removed,0,4,Samples/BasicHologram/cppwinrt/packages.config,medium,0
Windows-universal-samples,879,1,6,modified,6,0,Samples/XamlUIBasics/cs/AppUIBasics/ControlPages/NavigationViewPage.xaml,medium,0
Windows-universal-samples,875,1,5,modified,5,0,Samples/ResizeAppView/cpp/Scenario1_Basic.xaml.cpp,high,0
Windows-universal-samples,874,2,4,modified,2,2,Samples/XamlUIBasics/cs/AppUIBasics/ControlPages/TextBoxPage.xaml,medium,0
Windows-universal-samples,864,2,28,modified,10,18,README.md,low,3
Windows-universal-samples,864,2,2,modified,1,1,Samples/BackgroundTransfer/README.md,low,1
Windows-universal-samples,864,2,66,modified,33,33,Samples/BackgroundTransfer/cpp/BackgroundTransfer.sln,low,1
Windows-universal-samples,864,2,13,modified,10,3,Samples/BackgroundTransfer/cpp/BackgroundTransfer/BackgroundTransfer.vcxproj,medium,1
Windows-universal-samples,864,2,3,modified,3,0,Samples/BackgroundTransfer/cpp/BackgroundTransfer/BackgroundTransfer.vcxproj.filters,medium,1
Windows-universal-samples,864,2,2,modified,1,1,Samples/BackgroundTransfer/cpp/BackgroundTransfer/Package.appxmanifest,medium,1
Windows-universal-samples,864,2,1,modified,1,0,Samples/BackgroundTransfer/cpp/BackgroundTransfer/SampleConfiguration.cpp,high,1
Windows-universal-samples,864,2,2,modified,1,1,Samples/BackgroundTransfer/cpp/BackgroundTransfer/Scenario1_Download.xaml.cpp,high,1
Windows-universal-samples,864,2,4,modified,2,2,Samples/BackgroundTransfer/cpp/BackgroundTransfer/Scenario2_Upload.xaml.cpp,high,1
Windows-universal-samples,864,2,295,added,295,0,Samples/BackgroundTransfer/cpp/BackgroundTransfer/Scenario7_DownloadReordering.xaml.cpp,high,1
Windows-universal-samples,864,2,87,added,87,0,Samples/BackgroundTransfer/cpp/BackgroundTransfer/Scenario7_DownloadReordering.xaml.h,high,1
Windows-universal-samples,864,2,6,modified,3,3,Samples/BackgroundTransfer/cpp/Tasks/Tasks.vcxproj,medium,1
Windows-universal-samples,864,2,66,modified,33,33,Samples/BackgroundTransfer/cs/BackgroundTransfer.sln,low,1
Windows-universal-samples,864,2,14,modified,11,3,Samples/BackgroundTransfer/cs/BackgroundTransfer/BackgroundTransfer.csproj,low,1
Windows-universal-samples,864,2,2,modified,1,1,Samples/BackgroundTransfer/cs/BackgroundTransfer/Package.appxmanifest,medium,1
Windows-universal-samples,864,2,3,modified,2,1,Samples/BackgroundTransfer/cs/BackgroundTransfer/SampleConfiguration.cs,high,1
Windows-universal-samples,864,2,2,modified,1,1,Samples/BackgroundTransfer/cs/BackgroundTransfer/Scenario1_Download.xaml.cs,high,1
Windows-universal-samples,864,2,4,modified,2,2,Samples/BackgroundTransfer/cs/BackgroundTransfer/Scenario2_Upload.xaml.cs,high,1
Windows-universal-samples,864,2,2,modified,1,1,Samples/BackgroundTransfer/cs/BackgroundTransfer/Scenario3_Notifications.xaml.cs,high,1
Windows-universal-samples,864,2,321,added,321,0,Samples/BackgroundTransfer/cs/BackgroundTransfer/Scenario7_DownloadReordering.xaml.cs,high,1
Windows-universal-samples,864,2,6,modified,3,3,Samples/BackgroundTransfer/cs/Tasks/Tasks.csproj,low,1
Windows-universal-samples,864,2,8,modified,5,3,Samples/BackgroundTransfer/js/BackgroundTransfer.jsproj,high,1
Windows-universal-samples,864,2,50,modified,25,25,Samples/BackgroundTransfer/js/BackgroundTransfer.sln,low,1
Windows-universal-samples,864,2,65,added,65,0,Samples/BackgroundTransfer/js/html/scenario7_DownloadReordering.html,medium,1
Windows-universal-samples,864,2,3,modified,2,1,Samples/BackgroundTransfer/js/js/sample-configuration.js,high,1
Windows-universal-samples,864,2,38,modified,8,30,Samples/BackgroundTransfer/js/js/scenario1_Download.js,high,1
Windows-universal-samples,864,2,31,modified,4,27,Samples/BackgroundTransfer/js/js/scenario2_Upload.js,high,1
Windows-universal-samples,864,2,220,added,220,0,Samples/BackgroundTransfer/js/js/scenario7_DownloadReordering.js,high,1
Windows-universal-samples,864,2,2,modified,1,1,Samples/BackgroundTransfer/js/package.appxmanifest,medium,1
Windows-universal-samples,864,2,41,added,41,0,Samples/BackgroundTransfer/shared/Scenario7_DownloadReordering.xaml,medium,1
Windows-universal-samples,861,1,2,modified,1,1,Samples/SocketActivityStreamSocket/README.md,low,0
Windows-universal-samples,857,1,2,modified,1,1,Samples/BackgroundTransfer/README.md,low,2
Windows-universal-samples,857,1,11,modified,9,2,Samples/BackgroundTransfer/cpp/BackgroundTransfer/BackgroundTransfer.vcxproj,medium,2
Windows-universal-samples,857,1,3,modified,3,0,Samples/BackgroundTransfer/cpp/BackgroundTransfer/BackgroundTransfer.vcxproj.filters,medium,2
Windows-universal-samples,857,1,2,modified,1,1,Samples/BackgroundTransfer/cpp/BackgroundTransfer/Package.appxmanifest,medium,2
Windows-universal-samples,857,1,1,modified,1,0,Samples/BackgroundTransfer/cpp/BackgroundTransfer/SampleConfiguration.cpp,high,2
Windows-universal-samples,857,1,2,modified,1,1,Samples/BackgroundTransfer/cpp/BackgroundTransfer/Scenario1_Download.xaml.cpp,high,2
Windows-universal-samples,857,1,4,modified,2,2,Samples/BackgroundTransfer/cpp/BackgroundTransfer/Scenario2_Upload.xaml.cpp,high,2
Windows-universal-samples,857,1,295,added,295,0,Samples/BackgroundTransfer/cpp/BackgroundTransfer/Scenario7_DownloadReordering.xaml.cpp,high,2
Windows-universal-samples,857,1,87,added,87,0,Samples/BackgroundTransfer/cpp/BackgroundTransfer/Scenario7_DownloadReordering.xaml.h,high,2
Windows-universal-samples,857,1,4,modified,2,2,Samples/BackgroundTransfer/cpp/Tasks/Tasks.vcxproj,medium,2
Windows-universal-samples,857,1,12,modified,10,2,Samples/BackgroundTransfer/cs/BackgroundTransfer/BackgroundTransfer.csproj,low,2
Windows-universal-samples,857,1,2,modified,1,1,Samples/BackgroundTransfer/cs/BackgroundTransfer/Package.appxmanifest,medium,2
Windows-universal-samples,857,1,3,modified,2,1,Samples/BackgroundTransfer/cs/BackgroundTransfer/SampleConfiguration.cs,high,2
Windows-universal-samples,857,1,2,modified,1,1,Samples/BackgroundTransfer/cs/BackgroundTransfer/Scenario1_Download.xaml.cs,high,2
Windows-universal-samples,857,1,4,modified,2,2,Samples/BackgroundTransfer/cs/BackgroundTransfer/Scenario2_Upload.xaml.cs,high,2
Windows-universal-samples,857,1,2,modified,1,1,Samples/BackgroundTransfer/cs/BackgroundTransfer/Scenario3_Notifications.xaml.cs,high,2
Windows-universal-samples,857,1,321,added,321,0,Samples/BackgroundTransfer/cs/BackgroundTransfer/Scenario7_DownloadReordering.xaml.cs,high,2
Windows-universal-samples,857,1,4,modified,2,2,Samples/BackgroundTransfer/cs/Tasks/Tasks.csproj,low,2
Windows-universal-samples,857,1,6,modified,4,2,Samples/BackgroundTransfer/js/BackgroundTransfer.jsproj,high,2
Windows-universal-samples,857,1,65,added,65,0,Samples/BackgroundTransfer/js/html/scenario7_DownloadReordering.html,medium,2
Windows-universal-samples,857,1,3,modified,2,1,Samples/BackgroundTransfer/js/js/sample-configuration.js,high,2
Windows-universal-samples,857,1,38,modified,8,30,Samples/BackgroundTransfer/js/js/scenario1_Download.js,high,2
Windows-universal-samples,857,1,31,modified,4,27,Samples/BackgroundTransfer/js/js/scenario2_Upload.js,high,2
Windows-universal-samples,857,1,220,added,220,0,Samples/BackgroundTransfer/js/js/scenario7_DownloadReordering.js,high,2
Windows-universal-samples,857,1,2,modified,1,1,Samples/BackgroundTransfer/js/package.appxmanifest,medium,2
Windows-universal-samples,857,1,41,added,41,0,Samples/BackgroundTransfer/shared/Scenario7_DownloadReordering.xaml,medium,2
Windows-universal-samples,857,1,2,modified,1,1,Samples/BackgroundTransfer/vb/BackgroundTransfer/Scenario1_Download.xaml.vb,high,1
Windows-universal-samples,857,1,4,modified,2,2,Samples/BackgroundTransfer/vb/BackgroundTransfer/Scenario2_Upload.xaml.vb,high,1
Windows-universal-samples,857,1,1,modified,1,0,Samples/Ink/README.md,low,1
Windows-universal-samples,857,1,7,modified,5,2,Samples/Ink/js/Ink.jsproj,high,1
Windows-universal-samples,849,1,24,modified,15,9,Samples/360VideoPlayback/cpp/PlaybackPage.xaml.cpp,high,0
Windows-universal-samples,849,1,5,modified,3,2,Samples/360VideoPlayback/cpp/PlaybackPage.xaml.h,high,0
Windows-universal-samples,849,1,20,modified,12,8,Samples/360VideoPlayback/cs/PlaybackPage.xaml.cs,high,0
Windows-universal-samples,834,2,4,modified,2,2,Samples/HolographicFaceTracking/cpp/Content/NV12VideoTexture.cpp,high,0
Windows-universal-samples,831,0,80,modified,60,20,Samples/CameraGetPreviewFrame/cs/MainPage.xaml.cs,high,1
Windows-universal-samples,827,1,1,modified,1,0,Samples/XamlUIBasics/cs/AppUIBasics/Navigation/NavigationRootPage.xaml.cs,high,1
Windows-universal-samples,822,1,8,modified,5,3,Samples/XamlListView/cs/ListView.csproj,low,0
Windows-universal-samples,822,1,16,removed,0,16,Samples/XamlListView/cs/project.json,medium,0
Windows-universal-samples,811,0,2,modified,1,1,Samples/XamlUIBasics/README.md,low,3
Windows-universal-samples,806,2,8,modified,4,4,Samples/Notifications/js/Notifications/Notifications.jsproj,high,0
Windows-universal-samples,806,2,21,modified,11,10,Samples/Notifications/js/Notifications/js/scenario3-primarytilenotifications.js,high,0
Windows-universal-samples,806,2,20,modified,10,10,Samples/Notifications/js/Notifications/js/scenario4-secondarytilenotifications.js,high,0
Windows-universal-samples,806,2,18,modified,9,9,Samples/Notifications/js/Notifications/js/scenario5-expiringtilenotifications.js,high,0
Windows-universal-samples,806,2,18,modified,9,9,Samples/Notifications/js/Notifications/js/scenario6-schedulingtilenotifications.js,high,0
Windows-universal-samples,806,2,8,modified,4,4,Samples/Notifications/js/Notifications/js/scenario7-primarytilebadges.js,high,0
Windows-universal-samples,806,2,8,modified,4,4,Samples/Notifications/js/Notifications/js/scenario8-secondarytilebadges.js,high,0
Windows-universal-samples,806,2,2,modified,1,1,Samples/Notifications/js/Notifications/packages.config,medium,0
Windows-universal-samples,805,1,4,modified,2,2,Samples/MapControl/cs/MapControl.csproj,low,1
Windows-universal-samples,794,1,18,added,18,0,Samples/3DPrinting/cs/3DPrinting.nuget.targets,low,1
Windows-universal-samples,794,1,5,modified,3,2,Samples/3DPrinting/cs/project.json,medium,1
Windows-universal-samples,794,1,3,modified,3,0,SharedContent/cs/App.xaml.cs,high,1
Windows-universal-samples,791,1,8,modified,8,0,Samples/360VideoPlayback/cpp/Content/VideoRenderer.cpp,high,0
Windows-universal-samples,790,1,3,modified,2,1,Samples/360VideoPlayback/cpp/Common/DeviceResources.cpp,high,1
Windows-universal-samples,780,1,4,modified,2,2,Samples/360VideoPlayback/cs/Common/DeviceResources.cs,high,2
Windows-universal-samples,780,1,2,modified,2,0,Samples/XamlDataVirtualization/cs/Scenario1/ItemCacheManager.cs,high,1
Windows-universal-samples,776,1,8,modified,2,6,Samples/BarcodeScanner/cs/BarcodeScanner.sln,low,1
Windows-universal-samples,776,1,6,modified,2,4,Samples/BluetoothAdvertisement/js/BluetoothAdvertisement.sln,low,1
Windows-universal-samples,776,1,8,modified,2,6,Samples/CashDrawer/cs/CashDrawer.sln,low,1
Windows-universal-samples,776,1,8,modified,2,6,Samples/ContentIndexer/cs/ContentIndexer.sln,low,1
Windows-universal-samples,776,1,8,modified,2,6,Samples/ContextMenu/cs/ContextMenu.sln,low,1
Windows-universal-samples,776,1,8,modified,2,6,Samples/CustomHidDeviceAccess/cs/CustomHidDeviceAccess.sln,low,1
Windows-universal-samples,776,1,8,modified,2,6,Samples/CustomSerialDeviceAccess/cs/CustomSerialDeviceAccess.sln,low,1
Windows-universal-samples,776,1,8,modified,2,6,Samples/CustomUsbDeviceAccess/cs/CustomUsbDeviceAccess.sln,low,1
Windows-universal-samples,776,1,7,modified,2,5,Samples/Geolocation/cs/Geolocation.sln,low,1
Windows-universal-samples,776,1,8,modified,2,6,Samples/HomeGroup/cs/HomeGroup.sln,low,1
Windows-universal-samples,776,1,8,modified,2,6,Samples/MagneticStripeReader/cs/MagneticStripeReader.sln,low,1
Windows-universal-samples,776,1,8,modified,2,6,Samples/MessageDialog/cs/MessageDialogSample.sln,low,1
Windows-universal-samples,776,1,8,modified,2,6,Samples/SemanticTextQuery/cs/SemanticTextQuery.sln,low,1
Windows-universal-samples,773,36,7,modified,5,2,.gitignore,low,1
Windows-universal-samples,773,36,95,modified,55,40,README.md,low,3
Windows-universal-samples,773,36,16,added,16,0,Samples/360VideoPlayback/360-video-playback.yaml,medium,1
Windows-universal-samples,773,36,114,added,114,0,Samples/360VideoPlayback/README.md,low,0
Windows-universal-samples,773,36,32,added,32,0,Samples/360VideoPlayback/cpp/360VideoPlayback.sln,low,2
Windows-universal-samples,773,36,271,added,271,0,Samples/360VideoPlayback/cpp/360VideoPlayback.vcxproj,medium,2
Windows-universal-samples,773,36,156,added,156,0,Samples/360VideoPlayback/cpp/360VideoPlayback.vcxproj.filters,medium,0
Windows-universal-samples,773,36,495,added,495,0,Samples/360VideoPlayback/cpp/360VideoPlaybackMain.cpp,high,0
Windows-universal-samples,773,36,103,added,103,0,Samples/360VideoPlayback/cpp/360VideoPlaybackMain.h,high,0
Windows-universal-samples,773,36,111,added,111,0,Samples/360VideoPlayback/cpp/App.xaml.cpp,high,0
Windows-universal-samples,773,36,27,added,27,0,Samples/360VideoPlayback/cpp/App.xaml.h,high,0
Windows-universal-samples,773,36,289,added,289,0,Samples/360VideoPlayback/cpp/AppView.cpp,high,0
Windows-universal-samples,773,36,64,added,64,0,Samples/360VideoPlayback/cpp/AppView.h,high,0
Windows-universal-samples,773,36,505,added,505,0,Samples/360VideoPlayback/cpp/Common/BaseControl.cpp,high,0
Windows-universal-samples,773,36,79,added,79,0,Samples/360VideoPlayback/cpp/Common/BaseControl.h,high,0
Windows-universal-samples,773,36,480,added,480,0,Samples/360VideoPlayback/cpp/Common/BaseElement.cpp,high,0
Windows-universal-samples,773,36,217,added,217,0,Samples/360VideoPlayback/cpp/Common/BaseElement.h,high,0
Windows-universal-samples,773,36,274,added,274,0,Samples/360VideoPlayback/cpp/Common/CameraResources.cpp,high,0
Windows-universal-samples,773,36,76,added,76,0,Samples/360VideoPlayback/cpp/Common/CameraResources.h,high,0
Windows-universal-samples,773,36,247,added,247,0,Samples/360VideoPlayback/cpp/Common/Controls.cpp,high,0
Windows-universal-samples,773,36,69,added,69,0,Samples/360VideoPlayback/cpp/Common/Controls.h,high,0
Windows-universal-samples,773,36,372,added,372,0,Samples/360VideoPlayback/cpp/Common/DeviceResources.cpp,high,1
Windows-universal-samples,773,36,112,added,112,0,Samples/360VideoPlayback/cpp/Common/DeviceResources.h,high,0
Windows-universal-samples,773,36,59,added,59,0,Samples/360VideoPlayback/cpp/Common/DirectXHelper.h,high,1
Windows-universal-samples,773,36,306,added,306,0,Samples/360VideoPlayback/cpp/Common/MeshGeometry.cpp,high,0
Windows-universal-samples,773,36,39,added,39,0,Samples/360VideoPlayback/cpp/Common/MeshGeometry.h,high,0
Windows-universal-samples,773,36,216,added,216,0,Samples/360VideoPlayback/cpp/Common/SeekBarElement.cpp,high,0
Windows-universal-samples,773,36,51,added,51,0,Samples/360VideoPlayback/cpp/Common/SeekBarElement.h,high,0
Windows-universal-samples,773,36,189,added,189,0,Samples/360VideoPlayback/cpp/Common/StepTimer.h,high,0
Windows-universal-samples,773,36,31,added,31,0,Samples/360VideoPlayback/cpp/Content/GeometryShader.hlsl,high,0
Windows-universal-samples,759,1,6,modified,3,3,Samples/XamlUIBasics/cs/AppUIBasics/AppUIBasics.csproj,low,3
Windows-universal-samples,747,1,2,modified,1,1,Samples/XamlListView/cs/Model/Contact.cs,high,1
Windows-universal-samples,741,1,12,modified,2,10,Samples/XamlUIBasics/cs/AppUIBasics/AppUIBasics.csproj,low,4
Windows-universal-samples,741,1,0,removed,0,0,Samples/XamlUIBasics/cs/AppUIBasics/Assets/TreeView.png,low,1
Windows-universal-samples,741,1,42,removed,0,42,Samples/XamlUIBasics/cs/AppUIBasics/ControlPages/TreeViewPage.xaml,medium,1
Windows-universal-samples,741,1,49,removed,0,49,Samples/XamlUIBasics/cs/AppUIBasics/ControlPages/TreeViewPage.xaml.cs,high,1
Windows-universal-samples,741,1,25,modified,2,23,Samples/XamlUIBasics/cs/AppUIBasics/DataModel/ControlInfoData.json,medium,1
Windows-universal-samples,730,1,6,modified,0,6,Samples/BluetoothLE/cs/BluetoothLE.csproj,low,1
Windows-universal-samples,725,2,2,modified,1,1,Samples/SpeechRecognitionAndSynthesis/README.md,low,0
Windows-universal-samples,718,1,6,modified,4,2,Samples/BackgroundTask/cpp/BackgroundTask/Scenario5_ApplicationTriggerTask.xaml.cpp,high,0
Windows-universal-samples,718,1,6,modified,4,2,Samples/BackgroundTask/cs/BackgroundTask/Scenario5_ApplicationTriggerTask.xaml.cs,high,0
Windows-universal-samples,718,1,6,modified,3,3,Samples/BackgroundTask/shared/Scenario4_TimeTriggeredTask.xaml,medium,0
Windows-universal-samples,718,1,4,modified,3,1,Samples/BackgroundTask/vb/BackgroundTask/Scenario5_ApplicationTriggerTask.xaml.vb,high,0
Windows-universal-samples,704,1,1,modified,1,0,README.md,low,3
Windows-universal-samples,703,1,4,modified,2,2,Samples/XamlUIBasics/cs/AppUIBasics/AppUIBasics.csproj,low,4
Windows-universal-samples,703,1,2,modified,1,1,Samples/XamlUIBasics/cs/AppUIBasics/ControlPages/NavigationViewPage.xaml,medium,0
Windows-universal-samples,703,1,45,modified,21,24,Samples/XamlUIBasics/cs/AppUIBasics/ControlPages/NavigationViewPage.xaml.cs,high,0
Windows-universal-samples,703,1,4,modified,2,2,Samples/XamlUIBasics/cs/AppUIBasics/ControlPages/RatingsControlPage.xaml,medium,0
Windows-universal-samples,703,1,6,modified,3,3,Samples/XamlUIBasics/cs/AppUIBasics/ControlPages/RevealPage.xaml,medium,0
Windows-universal-samples,703,1,4,modified,2,2,Samples/XamlUIBasics/cs/AppUIBasics/ItemPage.xaml.cs,high,0
Windows-universal-samples,703,1,2,modified,1,1,Samples/XamlUIBasics/cs/AppUIBasics/MainPage.xaml.cs,high,0
Windows-universal-samples,703,1,2,modified,1,1,Samples/XamlUIBasics/cs/AppUIBasics/Navigation/NavigationRootPage.xaml,medium,0
Windows-universal-samples,703,1,38,modified,19,19,Samples/XamlUIBasics/cs/AppUIBasics/Navigation/NavigationRootPage.xaml.cs,high,1
Windows-universal-samples,703,1,2,modified,1,1,Samples/XamlUIBasics/cs/AppUIBasics/NewControlsPage.xaml.cs,high,0
Windows-universal-samples,703,1,2,modified,1,1,Samples/XamlUIBasics/cs/AppUIBasics/SectionPage.xaml.cs,high,0
Windows-universal-samples,697,1,2,modified,1,1,README.md,low,3
Windows-universal-samples,687,2,6,modified,3,3,Samples/XamlUIBasics/cs/AppUIBasics/AppUIBasics.csproj,low,5
Windows-universal-samples,687,2,2,modified,1,1,Samples/XamlUIBasics/cs/AppUIBasics/ControlPages/NavigationViewPage.xaml,medium,1
Windows-universal-samples,687,2,45,modified,21,24,Samples/XamlUIBasics/cs/AppUIBasics/ControlPages/NavigationViewPage.xaml.cs,high,1
Windows-universal-samples,687,2,4,modified,2,2,Samples/XamlUIBasics/cs/AppUIBasics/ControlPages/RatingsControlPage.xaml,medium,1
Windows-universal-samples,687,2,4,modified,2,2,Samples/XamlUIBasics/cs/AppUIBasics/ItemPage.xaml.cs,high,1
Windows-universal-samples,687,2,2,modified,1,1,Samples/XamlUIBasics/cs/AppUIBasics/MainPage.xaml.cs,high,1
Windows-universal-samples,687,2,2,modified,1,1,Samples/XamlUIBasics/cs/AppUIBasics/Navigation/NavigationRootPage.xaml,medium,1
Windows-universal-samples,687,2,38,modified,19,19,Samples/XamlUIBasics/cs/AppUIBasics/Navigation/NavigationRootPage.xaml.cs,high,2
Windows-universal-samples,687,2,2,modified,1,1,Samples/XamlUIBasics/cs/AppUIBasics/NewControlsPage.xaml.cs,high,1
Windows-universal-samples,687,2,2,modified,1,1,Samples/XamlUIBasics/cs/AppUIBasics/SectionPage.xaml.cs,high,1
Windows-universal-samples,670,3,63,modified,62,1,Samples/ShareTarget/cs/ShareTarget.xaml.cs,high,0
Windows-universal-samples,665,3,52,modified,41,11,Samples/Nfc/Nfc/TlvEntry.cs,high,0
Windows-universal-samples,665,3,19,modified,13,6,Samples/Nfc/PcscSdk/Iso7816.cs,high,0
Windows-universal-samples,652,0,12,modified,2,10,Samples/XamlUIBasics/cs/AppUIBasics/AppUIBasics.csproj,low,6
Windows-universal-samples,652,0,0,removed,0,0,Samples/XamlUIBasics/cs/AppUIBasics/Assets/TreeView.png,low,2
Windows-universal-samples,652,0,42,removed,0,42,Samples/XamlUIBasics/cs/AppUIBasics/ControlPages/TreeViewPage.xaml,medium,2
Windows-universal-samples,652,0,49,removed,0,49,Samples/XamlUIBasics/cs/AppUIBasics/ControlPages/TreeViewPage.xaml.cs,high,2
Windows-universal-samples,652,0,25,modified,2,23,Samples/XamlUIBasics/cs/AppUIBasics/DataModel/ControlInfoData.json,medium,2
Windows-universal-samples,628,0,7,modified,7,0,Samples/AudioCreation/cs/AudioCreation/Scenario1_FilePlayback.xaml.cs,high,1
Windows-universal-samples,623,0,2,modified,1,1,Samples/CortanaVoiceCommand/js/AdventureWorks/html/tripDetails.html,medium,1
Windows-universal-samples,623,0,2,modified,1,1,Samples/CortanaVoiceCommand/js/AdventureWorks/html/tripListView.html,medium,1
Windows-universal-samples,623,0,36,modified,7,29,Samples/CortanaVoiceCommand/js/AdventureWorks/package.appxmanifest,medium,1
Windows-universal-samples,623,0,16,modified,10,6,Samples/CortanaVoiceCommand/shared/AdventureWorksCommands.xml,medium,1
Windows-universal-samples,619,0,1,added,1,0,_config.yml,medium,1
Windows-universal-samples,617,3,11,modified,4,7,Samples/HolographicDepthBasedImageStabilization/README.md,low,1
Windows-universal-samples,617,3,2,modified,1,1,Samples/HolographicSpatialMapping/README.md,low,1
Windows-universal-samples,615,24,16,modified,12,4,Samples/AudioCreation/cs/AudioCreation/AudioCreation.csproj,low,0
Windows-universal-samples,615,24,3,modified,2,1,Samples/AudioCreation/cs/AudioCreation/SampleConfiguration.cs,high,0
Windows-universal-samples,615,24,79,added,79,0,Samples/AudioCreation/cs/AudioCreation/Scenario7_RecordPlayback.xaml,medium,0
Windows-universal-samples,615,24,592,added,592,0,Samples/AudioCreation/cs/AudioCreation/Scenario7_RecordPlayback.xaml.cs,high,0
Windows-universal-samples,615,24,2,modified,1,1,Samples/WindowsAudioSession/cpp/WindowsAudioSession.vcxproj,medium,0
Windows-universal-samples,614,1,4,modified,2,2,Samples/XamlCustomMediaTransportControls/README.md,low,1
Windows-universal-samples,609,4,5,modified,3,2,README.md,low,4
Windows-universal-samples,609,4,53,modified,1,52,Samples/Altimeter/cpp/SampleConfiguration.cpp,high,1
Windows-universal-samples,609,4,2,modified,0,2,Samples/Altimeter/cpp/SampleConfiguration.h,high,1
Windows-universal-samples,609,4,47,modified,25,22,Samples/Altimeter/cpp/Scenario1_DataEvents.xaml.cpp,high,1
Windows-universal-samples,609,4,29,modified,15,14,Samples/Altimeter/cpp/Scenario2_Polling.xaml.cpp,high,1
Windows-universal-samples,609,4,1,modified,0,1,Samples/Altimeter/cpp/Scenario2_Polling.xaml.h,high,1
Windows-universal-samples,609,4,48,modified,0,48,Samples/Altimeter/cs/SampleConfiguration.cs,high,1
Windows-universal-samples,609,4,22,modified,15,7,Samples/Altimeter/cs/Scenario1_DataEvents.xaml.cs,high,1
Windows-universal-samples,609,4,9,modified,7,2,Samples/Altimeter/cs/Scenario2_Polling.xaml.cs,high,1
Windows-universal-samples,609,4,42,modified,1,41,Samples/Altimeter/js/js/sample-configuration.js,high,1
Windows-universal-samples,609,4,35,modified,20,15,Samples/Altimeter/js/js/scenario1_DataEvents.js,high,1
Windows-universal-samples,609,4,24,modified,14,10,Samples/Altimeter/js/js/scenario2_Polling.js,high,1
Windows-universal-samples,609,4,4,modified,2,2,Samples/BarcodeScanner/cpp/BarcodeScanner.vcxproj,medium,1
Windows-universal-samples,609,4,2,modified,1,1,Samples/BarcodeScanner/cpp/Package.appxmanifest,medium,1
Windows-universal-samples,609,4,2,modified,2,0,Samples/BarcodeScanner/cpp/Scenario2_MultipleScanners.xaml.cpp,high,1
Windows-universal-samples,609,4,4,modified,2,2,Samples/BarcodeScanner/cs/BarcodeScanner.csproj,low,1
Windows-universal-samples,609,4,2,modified,1,1,Samples/BarcodeScanner/cs/Package.appxmanifest,medium,1
Windows-universal-samples,609,4,6,modified,5,1,Samples/BarcodeScanner/cs/Scenario1_BasicFunctionality.xaml.cs,high,1
Windows-universal-samples,609,4,92,modified,68,24,Samples/BarcodeScanner/cs/Scenario2_MultipleScanners.xaml.cs,high,1
Windows-universal-samples,609,4,4,modified,2,2,Samples/BarcodeScanner/js/BarcodeScanner.jsproj,high,1
Windows-universal-samples,609,4,2,modified,1,1,Samples/BarcodeScanner/js/Package.appxmanifest,medium,1
Windows-universal-samples,609,4,12,modified,10,2,Samples/BarcodeScanner/js/js/scenario1_BasicFunctionality.js,high,1
Windows-universal-samples,609,4,24,modified,20,4,Samples/BarcodeScanner/js/js/scenario2_MultipleScanners.js,high,1
Windows-universal-samples,609,4,4,modified,2,2,Samples/CameraFrames/cpp/CameraFrames.vcxproj,medium,1
Windows-universal-samples,609,4,20,modified,11,9,Samples/CameraFrames/cpp/FrameRenderer.cpp,high,1
Windows-universal-samples,609,4,2,modified,1,1,Samples/CameraFrames/cpp/Package.appxmanifest,medium,1
Windows-universal-samples,609,4,4,modified,2,2,Samples/CameraFrames/cs/CameraFrames.csproj,low,1
Windows-universal-samples,609,4,30,modified,17,13,Samples/CameraFrames/cs/FrameRenderer.cs,high,1
Windows-universal-samples,609,4,2,modified,1,1,Samples/CameraFrames/cs/Package.appxmanifest,medium,1
Windows-universal-samples,609,4,4,modified,2,2,Samples/CashDrawer/cpp/CashDrawer.vcxproj,medium,1
Windows-universal-samples,600,50,238,modified,144,94,README.md,low,5
Windows-universal-samples,600,50,45,added,45,0,Samples/3DPrinting/README.md,low,1
Windows-universal-samples,600,50,181,added,181,0,Samples/3DPrinting/cs/3DPrinting.csproj,low,3
Windows-universal-samples,600,50,40,added,40,0,Samples/3DPrinting/cs/3DPrinting.sln,low,3
Windows-universal-samples,600,50,0,added,0,0,Samples/3DPrinting/cs/Assets/msLogo.png,low,1
Windows-universal-samples,600,50,39,added,39,0,Samples/3DPrinting/cs/Package.appxmanifest,medium,3
Windows-universal-samples,600,50,34,added,34,0,Samples/3DPrinting/cs/SampleConfiguration.cs,high,1
Windows-universal-samples,600,50,43,added,43,0,Samples/3DPrinting/cs/Scenario1_Print.xaml,medium,1
Windows-universal-samples,600,50,488,added,488,0,Samples/3DPrinting/cs/Scenario1_Print.xaml.cs,high,1
Windows-universal-samples,600,50,30,added,30,0,Samples/3DPrinting/cs/Scenario2_Launch.xaml,medium,1
Windows-universal-samples,600,50,73,added,73,0,Samples/3DPrinting/cs/Scenario2_Launch.xaml.cs,high,1
Windows-universal-samples,600,50,19,added,19,0,Samples/3DPrinting/cs/project.json,medium,2
Windows-universal-samples,600,50,555,added,555,0,Samples/3DPrintingFromUnity/Assets/Script/Print3D.cs,high,1
Windows-universal-samples,600,50,17,added,17,0,Samples/3DPrintingFromUnity/Assets/Script/Turn.cs,high,1
Windows-universal-samples,600,50,145,added,145,0,Samples/3DPrintingFromUnity/README.md,low,2
Windows-universal-samples,600,50,30,modified,22,8,Samples/Accelerometer/README.md,low,1
Windows-universal-samples,600,50,11,modified,9,2,Samples/Accelerometer/cpp/Accelerometer.vcxproj,medium,3
Windows-universal-samples,600,50,3,modified,3,0,Samples/Accelerometer/cpp/Accelerometer.vcxproj.filters,medium,1
Windows-universal-samples,600,50,2,modified,1,1,Samples/Accelerometer/cpp/Package.appxmanifest,medium,3
Windows-universal-samples,600,50,1,modified,1,0,Samples/Accelerometer/cpp/SampleConfiguration.cpp,high,1
Windows-universal-samples,600,50,15,modified,14,1,Samples/Accelerometer/cpp/SampleConfiguration.h,high,1
Windows-universal-samples,600,50,53,added,53,0,Samples/Accelerometer/cpp/Scenario0_Choose.xaml.cpp,high,1
Windows-universal-samples,600,50,42,added,42,0,Samples/Accelerometer/cpp/Scenario0_Choose.xaml.h,high,1
Windows-universal-samples,600,50,5,modified,3,2,Samples/Accelerometer/cpp/Scenario1_DataEvents.xaml.cpp,high,1
Windows-universal-samples,600,50,5,modified,3,2,Samples/Accelerometer/cpp/Scenario2_ShakeEvents.xaml.cpp,high,1
Windows-universal-samples,600,50,5,modified,3,2,Samples/Accelerometer/cpp/Scenario3_Polling.xaml.cpp,high,1
Windows-universal-samples,600,50,11,modified,6,5,Samples/Accelerometer/cpp/Scenario4_OrientationChanged.xaml.cpp,high,1
Windows-universal-samples,600,50,7,modified,4,3,Samples/Accelerometer/cpp/Scenario5_DataEventsBatching.xaml.cpp,high,1
Windows-universal-samples,600,50,10,modified,8,2,Samples/Accelerometer/cs/Accelerometer.csproj,low,3
Windows-universal-samples,600,50,2,modified,1,1,Samples/Accelerometer/cs/Package.appxmanifest,medium,3
Windows-universal-samples,592,0,1,modified,1,0,README.md,low,5
Windows-universal-samples,592,0,115,added,115,0,Samples/HolographicViewSwitcher/README.md,low,0
Windows-universal-samples,592,0,200,added,200,0,Samples/HolographicViewSwitcher/cpp/AppView.cpp,high,0
Windows-universal-samples,592,0,63,added,63,0,Samples/HolographicViewSwitcher/cpp/AppView.h,high,0
Windows-universal-samples,592,0,0,added,0,0,Samples/HolographicViewSwitcher/cpp/Assets/holoHello.dds,low,0
Windows-universal-samples,592,0,272,added,272,0,Samples/HolographicViewSwitcher/cpp/Common/CameraResources.cpp,high,0
Windows-universal-samples,592,0,86,added,86,0,Samples/HolographicViewSwitcher/cpp/Common/CameraResources.h,high,0
Windows-universal-samples,592,0,361,added,361,0,Samples/HolographicViewSwitcher/cpp/Common/DeviceResources.cpp,high,0
Windows-universal-samples,592,0,117,added,117,0,Samples/HolographicViewSwitcher/cpp/Common/DeviceResources.h,high,0
Windows-universal-samples,592,0,70,added,70,0,Samples/HolographicViewSwitcher/cpp/Common/DirectXHelper.h,high,0
Windows-universal-samples,592,0,200,added,200,0,Samples/HolographicViewSwitcher/cpp/Common/StepTimer.h,high,0
Windows-universal-samples,592,0,96,added,96,0,Samples/HolographicViewSwitcher/cpp/Content/CreateDistanceFieldPixelShader.hlsl,high,0
Windows-universal-samples,592,0,1828,added,1828,0,Samples/HolographicViewSwitcher/cpp/Content/DDSTextureLoader.cpp,high,0
Windows-universal-samples,592,0,156,added,156,0,Samples/HolographicViewSwitcher/cpp/Content/DDSTextureLoader.h,high,0
Windows-universal-samples,592,0,20,added,20,0,Samples/HolographicViewSwitcher/cpp/Content/FullscreenQuadVertexShader.hlsl,high,0
Windows-universal-samples,592,0,46,added,46,0,Samples/HolographicViewSwitcher/cpp/Content/GeometryShader.hlsl,high,0
Windows-universal-samples,592,0,31,added,31,0,Samples/HolographicViewSwitcher/cpp/Content/PixelShader.hlsl,high,0
Windows-universal-samples,592,0,485,added,485,0,Samples/HolographicViewSwitcher/cpp/Content/QuadRenderer.cpp,high,0
Windows-universal-samples,592,0,90,added,90,0,Samples/HolographicViewSwitcher/cpp/Content/QuadRenderer.h,high,0
Windows-universal-samples,592,0,36,added,36,0,Samples/HolographicViewSwitcher/cpp/Content/ShaderStructures.h,high,0
Windows-universal-samples,592,0,57,added,57,0,Samples/HolographicViewSwitcher/cpp/Content/SpatialInputHandler.cpp,high,0
Windows-universal-samples,592,0,41,added,41,0,Samples/HolographicViewSwitcher/cpp/Content/SpatialInputHandler.h,high,0
Windows-universal-samples,592,0,29,added,29,0,Samples/HolographicViewSwitcher/cpp/Content/TexturePixelShader.hlsl,high,0
Windows-universal-samples,592,0,73,added,73,0,Samples/HolographicViewSwitcher/cpp/Content/VPRTVertexShader.hlsl,high,0
Windows-universal-samples,592,0,75,added,75,0,Samples/HolographicViewSwitcher/cpp/Content/VertexShader.hlsl,high,0
Windows-universal-samples,592,0,40,added,40,0,Samples/HolographicViewSwitcher/cpp/HolographicViewSwitcher.sln,low,0
Windows-universal-samples,592,0,296,added,296,0,Samples/HolographicViewSwitcher/cpp/HolographicViewSwitcher.vcxproj,medium,0
Windows-universal-samples,592,0,168,added,168,0,Samples/HolographicViewSwitcher/cpp/HolographicViewSwitcher.vcxproj.filters,medium,0
Windows-universal-samples,592,0,404,added,404,0,Samples/HolographicViewSwitcher/cpp/HolographicViewSwitcherMain.cpp,high,0
Windows-universal-samples,592,0,104,added,104,0,Samples/HolographicViewSwitcher/cpp/HolographicViewSwitcherMain.h,high,0
Windows-universal-samples,574,2,17,modified,8,9,Samples/RadialController/cpp/RadialController.vcxproj,medium,1
Windows-universal-samples,574,2,9,modified,4,5,Samples/RadialController/cpp/RadialController.vcxproj.filters,medium,1
Windows-universal-samples,574,2,130,modified,82,48,Samples/RadialController/cpp/Scenario1_EventAndMenuHookup.xaml.cpp,high,1
Windows-universal-samples,574,2,26,modified,14,12,Samples/RadialController/cpp/Scenario1_EventAndMenuHookup.xaml.h,high,1
Windows-universal-samples,574,2,0,renamed,0,0,Samples/RadialController/cs/Assets/Item3.png,low,1
Windows-universal-samples,574,2,0,added,0,0,Samples/RadialController/cs/Assets/fontawesome-webfont.ttf,NaN,1
Windows-universal-samples,574,2,15,modified,4,11,Samples/RadialController/cs/RadialController.csproj,low,1
Windows-universal-samples,574,2,118,modified,82,36,Samples/RadialController/cs/Scenario1_EventAndMenuHookup.xaml.cs,high,1
Windows-universal-samples,574,2,2,modified,1,1,Samples/RadialController/cs/Scenario2_SystemDefaultMenu.xaml.cs,high,1
Windows-universal-samples,574,2,0,modified,0,0,Samples/RadialController/shared/Item2.png,low,1
Windows-universal-samples,574,2,0,modified,0,0,Samples/RadialController/shared/Item3.png,low,1
Windows-universal-samples,574,2,0,removed,0,0,Samples/RadialController/shared/Item5.png,low,1
Windows-universal-samples,574,2,71,modified,35,36,Samples/RadialController/shared/Scenario1_EventAndMenuHookup.xaml,medium,1
Windows-universal-samples,574,2,20,modified,10,10,Samples/RadialController/shared/Scenario2_SystemDefaultMenu.xaml,medium,1
Windows-universal-samples,574,2,0,added,0,0,Samples/RadialController/shared/fontawesome-webfont.ttf,NaN,1
Windows-universal-samples,566,5,29,modified,20,9,Samples/SerialArduino/README.md,low,0
Windows-universal-samples,566,5,0,added,0,0,Samples/SerialArduino/SerialCommand/SerialCommand.fzz,NaN,0
Windows-universal-samples,566,5,62,renamed,26,36,Samples/SerialArduino/SerialCommand/SerialCommand.ino,NaN,0
Windows-universal-samples,566,5,5,modified,3,2,Samples/SerialArduino/cs/Constants.cs,high,0
Windows-universal-samples,566,5,2,modified,1,1,Samples/SerialArduino/cs/Package.appxmanifest,medium,0
Windows-universal-samples,566,5,2,modified,1,1,Samples/SerialArduino/cs/SampleConfiguration.cs,high,0
Windows-universal-samples,566,5,11,modified,8,3,Samples/SerialArduino/cs/Scenario2_LEDTemp.xaml,medium,0
Windows-universal-samples,566,5,86,modified,76,10,Samples/SerialArduino/cs/Scenario2_LEDTemp.xaml.cs,high,0
Windows-universal-samples,566,5,0,removed,0,0,Samples/SerialArduino/sketch/SerialCommand.fzz,NaN,0
Windows-universal-samples,564,1,41,modified,41,0,Samples/AudioCreation/cs/AudioCreation/Scenario2_DeviceCapture.xaml.cs,high,1
Windows-universal-samples,562,0,2,modified,1,1,Samples/DeviceEnumerationAndPairing/cs/Scenario9_CustomPairDevice.xaml.cs,high,1
Windows-universal-samples,549,33,85,modified,58,27,README.md,low,6
Windows-universal-samples,549,33,13,modified,11,2,Samples/3DPrinting/README.md,low,2
Windows-universal-samples,549,33,6,modified,3,3,Samples/3DPrinting/cs/3DPrinting.csproj,low,4
Windows-universal-samples,549,33,38,modified,19,19,Samples/3DPrinting/cs/3DPrinting.sln,low,4
Windows-universal-samples,549,33,2,modified,1,1,Samples/3DPrinting/cs/Package.appxmanifest,medium,4
Windows-universal-samples,549,33,35,modified,20,15,Samples/3DPrintingFromUnity/README.md,low,3
Windows-universal-samples,549,33,30,modified,22,8,Samples/Accelerometer/README.md,low,2
Windows-universal-samples,549,33,38,modified,19,19,Samples/Accelerometer/cpp/Accelerometer.sln,low,3
Windows-universal-samples,549,33,13,modified,10,3,Samples/Accelerometer/cpp/Accelerometer.vcxproj,medium,4
Windows-universal-samples,549,33,3,modified,3,0,Samples/Accelerometer/cpp/Accelerometer.vcxproj.filters,medium,2
Windows-universal-samples,549,33,2,modified,1,1,Samples/Accelerometer/cpp/Package.appxmanifest,medium,4
Windows-universal-samples,549,33,1,modified,1,0,Samples/Accelerometer/cpp/SampleConfiguration.cpp,high,2
Windows-universal-samples,549,33,15,modified,14,1,Samples/Accelerometer/cpp/SampleConfiguration.h,high,2
Windows-universal-samples,549,33,53,added,53,0,Samples/Accelerometer/cpp/Scenario0_Choose.xaml.cpp,high,2
Windows-universal-samples,549,33,42,added,42,0,Samples/Accelerometer/cpp/Scenario0_Choose.xaml.h,high,2
Windows-universal-samples,549,33,5,modified,3,2,Samples/Accelerometer/cpp/Scenario1_DataEvents.xaml.cpp,high,2
Windows-universal-samples,549,33,5,modified,3,2,Samples/Accelerometer/cpp/Scenario2_ShakeEvents.xaml.cpp,high,2
Windows-universal-samples,549,33,5,modified,3,2,Samples/Accelerometer/cpp/Scenario3_Polling.xaml.cpp,high,2
Windows-universal-samples,549,33,11,modified,6,5,Samples/Accelerometer/cpp/Scenario4_OrientationChanged.xaml.cpp,high,2
Windows-universal-samples,549,33,7,modified,4,3,Samples/Accelerometer/cpp/Scenario5_DataEventsBatching.xaml.cpp,high,2
Windows-universal-samples,549,33,12,modified,9,3,Samples/Accelerometer/cs/Accelerometer.csproj,low,4
Windows-universal-samples,549,33,38,modified,19,19,Samples/Accelerometer/cs/Accelerometer.sln,low,3
Windows-universal-samples,549,33,2,modified,1,1,Samples/Accelerometer/cs/Package.appxmanifest,medium,4
Windows-universal-samples,549,33,5,modified,4,1,Samples/Accelerometer/cs/SampleConfiguration.cs,high,1
Windows-universal-samples,549,33,46,added,46,0,Samples/Accelerometer/cs/Scenario0_Choose.xaml.cs,high,1
Windows-universal-samples,549,33,5,modified,3,2,Samples/Accelerometer/cs/Scenario1_DataEvents.xaml.cs,high,1
Windows-universal-samples,549,33,5,modified,3,2,Samples/Accelerometer/cs/Scenario2_ShakeEvents.xaml.cs,high,2
Windows-universal-samples,549,33,5,modified,3,2,Samples/Accelerometer/cs/Scenario3_Polling.xaml.cs,high,1
Windows-universal-samples,549,33,9,modified,5,4,Samples/Accelerometer/cs/Scenario4_OrientationChanged.xaml.cs,high,1
Windows-universal-samples,549,33,5,modified,3,2,Samples/Accelerometer/cs/Scenario5_DataEventsBatching.xaml.cs,high,1
Windows-universal-samples,534,1,3,added,3,0,Samples/BackButton/cpp/.gitignore,low,1
Windows-universal-samples,534,1,157,added,157,0,Samples/BackButton/cpp/App.xaml.cpp,high,1
Windows-universal-samples,534,1,35,added,35,0,Samples/BackButton/cpp/App.xaml.h,high,1
Windows-universal-samples,534,1,146,added,146,0,Samples/BackButton/cpp/MainPage.xaml.cpp,high,1
Windows-universal-samples,534,1,45,added,45,0,Samples/BackButton/cpp/MainPage.xaml.h,high,1
Windows-universal-samples,534,1,53,added,53,0,Samples/BackButton/cpp/Package.appxmanifest,medium,1
Windows-universal-samples,534,1,21,added,21,0,Samples/BackButton/cpp/SampleConfiguration.cpp,high,1
Windows-universal-samples,534,1,47,added,47,0,Samples/BackButton/cpp/SampleConfiguration.h,high,1
Windows-universal-samples,534,1,56,added,56,0,Samples/BackButton/cpp/Scenario1.xaml.cpp,high,1
Windows-universal-samples,534,1,39,added,39,0,Samples/BackButton/cpp/Scenario1.xaml.h,high,1
Windows-universal-samples,534,1,48,added,48,0,Samples/BackButton/cpp/SecondaryPage.xaml.cpp,high,1
Windows-universal-samples,534,1,25,added,25,0,Samples/BackButton/cpp/SecondaryPage.xaml.h,high,1
Windows-universal-samples,534,1,536,added,536,0,Samples/BackButton/cpp/Styles.xaml,medium,1
Windows-universal-samples,534,1,40,added,40,0,Samples/BackButton/cpp/SystemBack.sln,low,1
Windows-universal-samples,534,1,217,added,217,0,Samples/BackButton/cpp/SystemBack.vcxproj,medium,1
Windows-universal-samples,534,1,63,added,63,0,Samples/BackButton/cpp/SystemBack.vcxproj.filters,medium,1
Windows-universal-samples,534,1,6,added,6,0,Samples/BackButton/cpp/pch.cpp,high,1
Windows-universal-samples,534,1,11,added,11,0,Samples/BackButton/cpp/pch.h,high,1
Windows-universal-samples,533,1,3,added,3,0,Samples/BackButton/cpp/.gitignore,low,2
Windows-universal-samples,533,1,34,added,34,0,Samples/BackButton/cpp/App.xaml,medium,1
Windows-universal-samples,533,1,157,added,157,0,Samples/BackButton/cpp/App.xaml.cpp,high,2
Windows-universal-samples,533,1,35,added,35,0,Samples/BackButton/cpp/App.xaml.h,high,2
Windows-universal-samples,533,1,80,added,80,0,Samples/BackButton/cpp/MainPage.xaml,medium,1
Windows-universal-samples,533,1,146,added,146,0,Samples/BackButton/cpp/MainPage.xaml.cpp,high,2
Windows-universal-samples,533,1,45,added,45,0,Samples/BackButton/cpp/MainPage.xaml.h,high,2
Windows-universal-samples,533,1,53,added,53,0,Samples/BackButton/cpp/Package.appxmanifest,medium,2
Windows-universal-samples,533,1,21,added,21,0,Samples/BackButton/cpp/SampleConfiguration.cpp,high,2
Windows-universal-samples,533,1,47,added,47,0,Samples/BackButton/cpp/SampleConfiguration.h,high,2
Windows-universal-samples,533,1,56,added,56,0,Samples/BackButton/cpp/Scenario1.xaml.cpp,high,2
Windows-universal-samples,533,1,39,added,39,0,Samples/BackButton/cpp/Scenario1.xaml.h,high,2
Windows-universal-samples,533,1,48,added,48,0,Samples/BackButton/cpp/SecondaryPage.xaml.cpp,high,2
Windows-universal-samples,533,1,25,added,25,0,Samples/BackButton/cpp/SecondaryPage.xaml.h,high,2
Windows-universal-samples,533,1,536,added,536,0,Samples/BackButton/cpp/Styles.xaml,medium,2
Windows-universal-samples,533,1,40,added,40,0,Samples/BackButton/cpp/SystemBack.sln,low,2
Windows-universal-samples,533,1,216,added,216,0,Samples/BackButton/cpp/SystemBack.vcxproj,medium,2
Windows-universal-samples,533,1,63,added,63,0,Samples/BackButton/cpp/SystemBack.vcxproj.filters,medium,2
Windows-universal-samples,533,1,6,added,6,0,Samples/BackButton/cpp/pch.cpp,high,2
Windows-universal-samples,533,1,11,added,11,0,Samples/BackButton/cpp/pch.h,high,2
Windows-universal-samples,532,1,131,added,131,0,Samples/BasicInput/cpp/1-InputEvents.xaml.cpp,high,1
Windows-universal-samples,532,1,39,added,39,0,Samples/BasicInput/cpp/1-InputEvents.xaml.h,high,1
Windows-universal-samples,532,1,248,added,248,0,Samples/BasicInput/cpp/2-PointerPointProperties.xaml.cpp,high,1
Windows-universal-samples,532,1,49,added,49,0,Samples/BasicInput/cpp/2-PointerPointProperties.xaml.h,high,1
Windows-universal-samples,532,1,63,added,63,0,Samples/BasicInput/cpp/3-DeviceCapabilities.xaml.cpp,high,1
Windows-universal-samples,532,1,31,added,31,0,Samples/BasicInput/cpp/3-DeviceCapabilities.xaml.h,high,1
Windows-universal-samples,532,1,170,added,170,0,Samples/BasicInput/cpp/4-XAMLManipulations.xaml.cpp,high,1
Windows-universal-samples,532,1,46,added,46,0,Samples/BasicInput/cpp/4-XAMLManipulations.xaml.h,high,1
Windows-universal-samples,532,1,282,added,282,0,Samples/BasicInput/cpp/5-GestureRecognizer.xaml.cpp,high,1
Windows-universal-samples,532,1,71,added,71,0,Samples/BasicInput/cpp/5-GestureRecognizer.xaml.h,high,1
Windows-universal-samples,532,1,40,added,40,0,Samples/BasicInput/cpp/BasicInput.sln,low,1
Windows-universal-samples,532,1,239,added,239,0,Samples/BasicInput/cpp/BasicInput.vcxproj,medium,1
Windows-universal-samples,532,1,74,added,74,0,Samples/BasicInput/cpp/BasicInput.vcxproj.filters,medium,1
Windows-universal-samples,532,1,53,added,53,0,Samples/BasicInput/cpp/Package.appxmanifest,medium,1
Windows-universal-samples,532,1,25,added,25,0,Samples/BasicInput/cpp/SampleConfiguration.cpp,high,1
Windows-universal-samples,532,1,47,added,47,0,Samples/BasicInput/cpp/SampleConfiguration.h,high,1
Windows-universal-samples,532,1,5,added,5,0,Samples/BasicInput/cpp/pch.cpp,high,1
Windows-universal-samples,532,1,10,added,10,0,Samples/BasicInput/cpp/pch.h,high,1
Windows-universal-samples,531,1,32,added,32,0,Samples/SimpleInk/cpp/Package.appxmanifest,medium,1
Windows-universal-samples,531,1,60,added,60,0,Samples/SimpleInk/cpp/RecognizerHelper.cpp,high,1
Windows-universal-samples,531,1,17,added,17,0,Samples/SimpleInk/cpp/RecognizerHelper.h,high,1
Windows-universal-samples,531,1,41,added,41,0,Samples/SimpleInk/cpp/SampleConfiguration.cpp,high,1
Windows-universal-samples,531,1,53,added,53,0,Samples/SimpleInk/cpp/SampleConfiguration.h,high,1
Windows-universal-samples,531,1,53,added,53,0,Samples/SimpleInk/cpp/Scenario1.xaml,medium,1
Windows-universal-samples,531,1,44,added,44,0,Samples/SimpleInk/cpp/Scenario1.xaml.cpp,high,1
Windows-universal-samples,531,1,32,added,32,0,Samples/SimpleInk/cpp/Scenario1.xaml.h,high,1
Windows-universal-samples,531,1,93,added,93,0,Samples/SimpleInk/cpp/Scenario2.xaml,medium,1
Windows-universal-samples,531,1,226,added,226,0,Samples/SimpleInk/cpp/Scenario2.xaml.cpp,high,1
Windows-universal-samples,531,1,74,added,74,0,Samples/SimpleInk/cpp/Scenario2.xaml.h,high,1
Windows-universal-samples,531,1,176,added,176,0,Samples/SimpleInk/cpp/Scenario3.xaml,medium,1
Windows-universal-samples,531,1,329,added,329,0,Samples/SimpleInk/cpp/Scenario3.xaml.cpp,high,1
Windows-universal-samples,531,1,51,added,51,0,Samples/SimpleInk/cpp/Scenario3.xaml.h,high,1
Windows-universal-samples,531,1,67,added,67,0,Samples/SimpleInk/cpp/Scenario4.xaml,medium,1
Windows-universal-samples,531,1,203,added,203,0,Samples/SimpleInk/cpp/Scenario4.xaml.cpp,high,1
Windows-universal-samples,531,1,48,added,48,0,Samples/SimpleInk/cpp/Scenario4.xaml.h,high,1
Windows-universal-samples,531,1,55,added,55,0,Samples/SimpleInk/cpp/Scenario5.xaml,medium,1
Windows-universal-samples,531,1,41,added,41,0,Samples/SimpleInk/cpp/Scenario5.xaml.cpp,high,1
Windows-universal-samples,531,1,31,added,31,0,Samples/SimpleInk/cpp/Scenario5.xaml.h,high,1
Windows-universal-samples,531,1,78,added,78,0,Samples/SimpleInk/cpp/Scenario6.xaml,medium,1
Windows-universal-samples,531,1,112,added,112,0,Samples/SimpleInk/cpp/Scenario6.xaml.cpp,high,1
Windows-universal-samples,531,1,45,added,45,0,Samples/SimpleInk/cpp/Scenario6.xaml.h,high,1
Windows-universal-samples,531,1,149,added,149,0,Samples/SimpleInk/cpp/Scenario7.xaml,medium,1
Windows-universal-samples,531,1,79,added,79,0,Samples/SimpleInk/cpp/Scenario7.xaml.cpp,high,1
Windows-universal-samples,531,1,38,added,38,0,Samples/SimpleInk/cpp/Scenario7.xaml.h,high,1
Windows-universal-samples,531,1,46,added,46,0,Samples/SimpleInk/cpp/Scenario8.xaml,medium,1
Windows-universal-samples,531,1,211,added,211,0,Samples/SimpleInk/cpp/Scenario8.xaml.cpp,high,1
Windows-universal-samples,531,1,54,added,54,0,Samples/SimpleInk/cpp/Scenario8.xaml.h,high,1
Windows-universal-samples,531,1,40,added,40,0,Samples/SimpleInk/cpp/SimpleInk.sln,low,1
Windows-universal-samples,523,1,6,modified,5,1,Samples/FilePicker/cs/Scenario4_SaveFile.xaml.cs,high,1
Windows-universal-samples,523,1,125,added,125,0,Samples/FilePickerContracts/CachedFileUpdaterContract/CachedFileUpdaterContract.csproj,low,1
Windows-universal-samples,523,1,29,added,29,0,Samples/FilePickerContracts/CachedFileUpdaterContract/Properties/AssemblyInfo.cs,high,1
Windows-universal-samples,523,1,47,added,47,0,Samples/FilePickerContracts/CachedFileUpdaterContract/UpdateFileTask.cs,high,1
Windows-universal-samples,523,1,16,added,16,0,Samples/FilePickerContracts/CachedFileUpdaterContract/project.json,medium,1
Windows-universal-samples,523,1,117,added,117,0,Samples/FilePickerContracts/cs/BGTaskHelper.cs,high,1
Windows-universal-samples,523,1,125,added,125,0,Samples/FilePickerContracts/cs/CachedFileUpdaterContract.csproj,low,1
Windows-universal-samples,523,1,14,modified,7,7,Samples/FilePickerContracts/cs/CachedFileUpdaterPage.xaml,medium,1
Windows-universal-samples,523,1,42,modified,38,4,Samples/FilePickerContracts/cs/CachedFileUpdaterPage.xaml.cs,high,1
Windows-universal-samples,523,1,13,modified,5,8,Samples/FilePickerContracts/cs/CachedFileUpdater_Remote.xaml.cs,high,1
Windows-universal-samples,523,1,7,modified,7,0,Samples/FilePickerContracts/cs/FilePickerContracts.csproj,low,1
Windows-universal-samples,523,1,20,modified,19,1,Samples/FilePickerContracts/cs/FilePickerContracts.sln,low,1
Windows-universal-samples,523,1,1,modified,1,0,Samples/FilePickerContracts/cs/FileSavePicker_SaveToCachedFile.xaml,medium,1
Windows-universal-samples,523,1,26,modified,23,3,Samples/FilePickerContracts/cs/FileSavePicker_SaveToCachedFile.xaml.cs,high,1
Windows-universal-samples,523,1,5,modified,5,0,Samples/FilePickerContracts/cs/Package.appxmanifest,medium,1
Windows-universal-samples,523,1,14,modified,7,7,Samples/FilePickerContracts/cs/project.json,medium,1
Windows-universal-samples,517,0,4,modified,4,0,Samples/RadialController/README.md,low,1
Windows-universal-samples,509,0,4,modified,2,2,Samples/XamlCommanding/cs/DynamicCommandBar.cs,high,0
Windows-universal-samples,502,0,4,modified,2,2,README.md,low,6
Windows-universal-samples,499,2,29,modified,18,11,Samples/CommunicationBlockAndFilter/cs/Scenario1_Register.xaml.cs,high,0
Windows-universal-samples,499,2,2,modified,1,1,Samples/CommunicationBlockAndFilter/cs/Tasks/project.json,medium,0
Windows-universal-samples,499,2,2,modified,1,1,Samples/CommunicationBlockAndFilter/cs/project.json,medium,0
Windows-universal-samples,487,40,224,modified,132,92,README.md,low,7
Windows-universal-samples,487,40,36,added,36,0,Samples/3DPrinting/README.md,low,3
Windows-universal-samples,487,40,181,added,181,0,Samples/3DPrinting/cs/3DPrinting.csproj,low,5
Windows-universal-samples,487,40,40,added,40,0,Samples/3DPrinting/cs/3DPrinting.sln,low,5
Windows-universal-samples,487,40,0,added,0,0,Samples/3DPrinting/cs/Assets/msLogo.png,low,2
Windows-universal-samples,487,40,39,added,39,0,Samples/3DPrinting/cs/Package.appxmanifest,medium,5
Windows-universal-samples,487,40,34,added,34,0,Samples/3DPrinting/cs/SampleConfiguration.cs,high,2
Windows-universal-samples,487,40,43,added,43,0,Samples/3DPrinting/cs/Scenario1_Print.xaml,medium,2
Windows-universal-samples,487,40,488,added,488,0,Samples/3DPrinting/cs/Scenario1_Print.xaml.cs,high,2
Windows-universal-samples,487,40,30,added,30,0,Samples/3DPrinting/cs/Scenario2_Launch.xaml,medium,2
Windows-universal-samples,487,40,73,added,73,0,Samples/3DPrinting/cs/Scenario2_Launch.xaml.cs,high,2
Windows-universal-samples,487,40,19,added,19,0,Samples/3DPrinting/cs/project.json,medium,3
Windows-universal-samples,487,40,555,added,555,0,Samples/3DPrintingFromUnity/Assets/Script/Print3D.cs,high,2
Windows-universal-samples,487,40,17,added,17,0,Samples/3DPrintingFromUnity/Assets/Script/Turn.cs,high,2
Windows-universal-samples,487,40,140,added,140,0,Samples/3DPrintingFromUnity/README.md,low,4
Windows-universal-samples,487,40,14,modified,11,3,Samples/Accelerometer/README.md,low,3
Windows-universal-samples,487,40,11,modified,9,2,Samples/Accelerometer/cpp/Accelerometer.vcxproj,medium,5
Windows-universal-samples,487,40,3,modified,3,0,Samples/Accelerometer/cpp/Accelerometer.vcxproj.filters,medium,3
Windows-universal-samples,487,40,2,modified,1,1,Samples/Accelerometer/cpp/Package.appxmanifest,medium,5
Windows-universal-samples,487,40,1,modified,1,0,Samples/Accelerometer/cpp/SampleConfiguration.cpp,high,3
Windows-universal-samples,487,40,15,modified,14,1,Samples/Accelerometer/cpp/SampleConfiguration.h,high,3
Windows-universal-samples,487,40,53,added,53,0,Samples/Accelerometer/cpp/Scenario0_Choose.xaml.cpp,high,3
Windows-universal-samples,487,40,42,added,42,0,Samples/Accelerometer/cpp/Scenario0_Choose.xaml.h,high,3
Windows-universal-samples,487,40,5,modified,3,2,Samples/Accelerometer/cpp/Scenario1_DataEvents.xaml.cpp,high,3
Windows-universal-samples,487,40,5,modified,3,2,Samples/Accelerometer/cpp/Scenario2_ShakeEvents.xaml.cpp,high,3
Windows-universal-samples,487,40,5,modified,3,2,Samples/Accelerometer/cpp/Scenario3_Polling.xaml.cpp,high,3
Windows-universal-samples,487,40,11,modified,6,5,Samples/Accelerometer/cpp/Scenario4_OrientationChanged.xaml.cpp,high,3
Windows-universal-samples,487,40,7,modified,4,3,Samples/Accelerometer/cpp/Scenario5_DataEventsBatching.xaml.cpp,high,3
Windows-universal-samples,487,40,10,modified,8,2,Samples/Accelerometer/cs/Accelerometer.csproj,low,5
Windows-universal-samples,487,40,2,modified,1,1,Samples/Accelerometer/cs/Package.appxmanifest,medium,5
Windows-universal-samples,482,1,19,modified,9,10,Samples/XamlUIBasics/cs/AppUIBasics/ControlPages/ListViewPage.xaml,medium,1
Windows-universal-samples,478,1,24,modified,24,0,Samples/BarcodeScanner/cs/Scenario1_BasicFunctionality.xaml.cs,high,1
Windows-universal-samples,472,4,17,added,17,0,Samples/3DPrinting/cs/.cr/Settings.xml,medium,1
Windows-universal-samples,472,4,10,modified,0,10,Samples/AppServices/cs/RandomNumberService/RandomNumberService.csproj,low,1
Windows-universal-samples,472,4,3,modified,2,1,Samples/AppServices/cs/RandomNumberService/project.json,medium,1
Windows-universal-samples,472,4,20,added,20,0,Samples/BluetoothLEClient/cs/.cr/Settings.xml,medium,1
Windows-universal-samples,472,4,20,added,20,0,Samples/DatagramSocket/cs/.cr/Settings.xml,medium,1
Windows-universal-samples,461,1,20,modified,10,10,README.md,low,8
Windows-universal-samples,437,1,2,modified,1,1,Samples/XamlNavigation/cs/Controls/NavMenuListView.cs,high,1
Windows-universal-samples,436,1,16,modified,8,8,Samples/AllJoyn/Common/Scenario1WinRTComponent/SecureInterfaceStructures.h,high,1
Windows-universal-samples,436,1,16,modified,8,8,Samples/AllJoyn/Common/Scenario2WinRTComponent/OnboardingStructures.h,high,1
Windows-universal-samples,435,1,48,modified,24,24,Samples/AllJoyn/ConsumerExperiences/cs/Scenario2ViewModel.cs,high,1
Windows-universal-samples,435,1,14,modified,1,13,Samples/AllJoyn/ProducerExperiences/cs/Scenario2ViewModel.cs,high,1
Windows-universal-samples,426,0,61,modified,35,26,Samples/CortanaVoiceCommand/cs/VoiceCommandService/AdventureWorksVoiceCommandService.cs,high,0
Windows-universal-samples,407,1,1,modified,1,0,Samples/XamlListView/cs/Model/GroupInfoList.cs,high,1
Windows-universal-samples,407,1,20,modified,12,8,Samples/XamlListView/cs/Samples/SimpleListViewSample/SimpleListViewSample.xaml,medium,1
Windows-universal-samples,407,1,24,modified,24,0,Samples/XamlListView/cs/Samples/SimpleListViewSample/SimpleListViewSample.xaml.cs,high,1
Windows-universal-samples,404,1,3,modified,2,1,Samples/Json/cs/User.cs,high,0
Windows-universal-samples,396,13,82,modified,48,34,README.md,low,8
Windows-universal-samples,396,13,2,modified,1,1,Samples/3DPrinting/cs/3DPrinting.csproj,low,5
Windows-universal-samples,396,13,2,modified,1,1,Samples/3DPrinting/cs/Package.appxmanifest,medium,5
Windows-universal-samples,396,13,14,modified,11,3,Samples/Accelerometer/README.md,low,3
Windows-universal-samples,396,13,11,modified,9,2,Samples/Accelerometer/cpp/Accelerometer.vcxproj,medium,5
Windows-universal-samples,396,13,3,modified,3,0,Samples/Accelerometer/cpp/Accelerometer.vcxproj.filters,medium,3
Windows-universal-samples,396,13,2,modified,1,1,Samples/Accelerometer/cpp/Package.appxmanifest,medium,5
Windows-universal-samples,396,13,1,modified,1,0,Samples/Accelerometer/cpp/SampleConfiguration.cpp,high,3
Windows-universal-samples,396,13,15,modified,14,1,Samples/Accelerometer/cpp/SampleConfiguration.h,high,3
Windows-universal-samples,396,13,53,added,53,0,Samples/Accelerometer/cpp/Scenario0_Choose.xaml.cpp,high,3
Windows-universal-samples,396,13,19,renamed,8,11,Samples/Accelerometer/cpp/Scenario0_Choose.xaml.h,high,3
Windows-universal-samples,396,13,5,modified,3,2,Samples/Accelerometer/cpp/Scenario1_DataEvents.xaml.cpp,high,3
Windows-universal-samples,396,13,5,modified,3,2,Samples/Accelerometer/cpp/Scenario2_ShakeEvents.xaml.cpp,high,3
Windows-universal-samples,396,13,5,modified,3,2,Samples/Accelerometer/cpp/Scenario3_Polling.xaml.cpp,high,3
Windows-universal-samples,396,13,11,modified,6,5,Samples/Accelerometer/cpp/Scenario4_OrientationChanged.xaml.cpp,high,3
Windows-universal-samples,396,13,7,modified,4,3,Samples/Accelerometer/cpp/Scenario5_DataEventsBatching.xaml.cpp,high,3
Windows-universal-samples,396,13,10,modified,8,2,Samples/Accelerometer/cs/Accelerometer.csproj,low,5
Windows-universal-samples,396,13,2,modified,1,1,Samples/Accelerometer/cs/Package.appxmanifest,medium,5
Windows-universal-samples,396,13,5,modified,4,1,Samples/Accelerometer/cs/SampleConfiguration.cs,high,1
Windows-universal-samples,396,13,46,added,46,0,Samples/Accelerometer/cs/Scenario0_Choose.xaml.cs,high,1
Windows-universal-samples,396,13,5,modified,3,2,Samples/Accelerometer/cs/Scenario1_DataEvents.xaml.cs,high,1
Windows-universal-samples,396,13,5,modified,3,2,Samples/Accelerometer/cs/Scenario2_ShakeEvents.xaml.cs,high,2
Windows-universal-samples,396,13,5,modified,3,2,Samples/Accelerometer/cs/Scenario3_Polling.xaml.cs,high,1
Windows-universal-samples,396,13,9,modified,5,4,Samples/Accelerometer/cs/Scenario4_OrientationChanged.xaml.cs,high,1
Windows-universal-samples,396,13,5,modified,3,2,Samples/Accelerometer/cs/Scenario5_DataEventsBatching.xaml.cs,high,1
Windows-universal-samples,396,13,6,modified,4,2,Samples/Accelerometer/js/Accelerometer.jsproj,high,2
Windows-universal-samples,396,13,2,modified,1,1,Samples/Accelerometer/js/Package.appxmanifest,medium,2
Windows-universal-samples,396,13,26,added,26,0,Samples/Accelerometer/js/html/scenario0_Choose.html,medium,0
Windows-universal-samples,396,13,6,modified,4,2,Samples/Accelerometer/js/js/sample-configuration.js,high,0
Windows-universal-samples,396,13,22,added,22,0,Samples/Accelerometer/js/js/scenario0_Choose.js,high,0
Windows-universal-samples,392,0,3,modified,2,1,Samples/ApplicationResources/cs/ApplicationResources.csproj,low,1
Windows-universal-samples,392,0,11,modified,9,2,Samples/ApplicationResources/cs/scenario7.xaml.cs,high,1
Windows-universal-samples,392,0,139,added,139,0,Samples/ApplicationResources/cs/strings/zh-cn/resources.resw,NaN,1
Windows-universal-samples,392,0,25,modified,25,0,Samples/ApplicationResources/shared/strings/en/resources.resw,NaN,1
Windows-universal-samples,392,0,10,modified,5,5,Samples/ApplicationResources/shared/xaml/scenario7.xaml,medium,1
Windows-universal-samples,391,5,48,modified,27,21,README.md,low,9
Windows-universal-samples,391,5,2,modified,1,1,Samples/3DPrinting/cs/3DPrinting.csproj,low,6
Windows-universal-samples,391,5,2,modified,1,1,Samples/3DPrinting/cs/Package.appxmanifest,medium,6
Windows-universal-samples,391,5,14,modified,11,3,Samples/Accelerometer/README.md,low,4
Windows-universal-samples,391,5,11,modified,9,2,Samples/Accelerometer/cpp/Accelerometer.vcxproj,medium,6
Windows-universal-samples,391,5,3,modified,3,0,Samples/Accelerometer/cpp/Accelerometer.vcxproj.filters,medium,4
Windows-universal-samples,391,5,2,modified,1,1,Samples/Accelerometer/cpp/Package.appxmanifest,medium,6
Windows-universal-samples,391,5,1,modified,1,0,Samples/Accelerometer/cpp/SampleConfiguration.cpp,high,4
Windows-universal-samples,391,5,15,modified,14,1,Samples/Accelerometer/cpp/SampleConfiguration.h,high,4
Windows-universal-samples,391,5,53,added,53,0,Samples/Accelerometer/cpp/Scenario0_Choose.xaml.cpp,high,4
Windows-universal-samples,391,5,19,renamed,8,11,Samples/Accelerometer/cpp/Scenario0_Choose.xaml.h,high,4
Windows-universal-samples,391,5,5,modified,3,2,Samples/Accelerometer/cpp/Scenario1_DataEvents.xaml.cpp,high,4
Windows-universal-samples,391,5,5,modified,3,2,Samples/Accelerometer/cpp/Scenario2_ShakeEvents.xaml.cpp,high,4
Windows-universal-samples,391,5,5,modified,3,2,Samples/Accelerometer/cpp/Scenario3_Polling.xaml.cpp,high,4
Windows-universal-samples,391,5,11,modified,6,5,Samples/Accelerometer/cpp/Scenario4_OrientationChanged.xaml.cpp,high,4
Windows-universal-samples,391,5,7,modified,4,3,Samples/Accelerometer/cpp/Scenario5_DataEventsBatching.xaml.cpp,high,4
Windows-universal-samples,391,5,10,modified,8,2,Samples/Accelerometer/cs/Accelerometer.csproj,low,6
Windows-universal-samples,391,5,2,modified,1,1,Samples/Accelerometer/cs/Package.appxmanifest,medium,6
Windows-universal-samples,391,5,5,modified,4,1,Samples/Accelerometer/cs/SampleConfiguration.cs,high,2
Windows-universal-samples,391,5,46,added,46,0,Samples/Accelerometer/cs/Scenario0_Choose.xaml.cs,high,2
Windows-universal-samples,391,5,5,modified,3,2,Samples/Accelerometer/cs/Scenario1_DataEvents.xaml.cs,high,2
Windows-universal-samples,391,5,5,modified,3,2,Samples/Accelerometer/cs/Scenario2_ShakeEvents.xaml.cs,high,3
Windows-universal-samples,391,5,5,modified,3,2,Samples/Accelerometer/cs/Scenario3_Polling.xaml.cs,high,2
Windows-universal-samples,391,5,9,modified,5,4,Samples/Accelerometer/cs/Scenario4_OrientationChanged.xaml.cs,high,2
Windows-universal-samples,391,5,5,modified,3,2,Samples/Accelerometer/cs/Scenario5_DataEventsBatching.xaml.cs,high,2
Windows-universal-samples,391,5,6,modified,4,2,Samples/Accelerometer/js/Accelerometer.jsproj,high,3
Windows-universal-samples,391,5,2,modified,1,1,Samples/Accelerometer/js/Package.appxmanifest,medium,3
Windows-universal-samples,391,5,26,added,26,0,Samples/Accelerometer/js/html/scenario0_Choose.html,medium,1
Windows-universal-samples,391,5,6,modified,4,2,Samples/Accelerometer/js/js/sample-configuration.js,high,1
Windows-universal-samples,391,5,22,added,22,0,Samples/Accelerometer/js/js/scenario0_Choose.js,high,1
Windows-universal-samples,389,1,78,removed,0,78,Samples/OCR/cpp/WordOverlay.cpp,high,1
Windows-universal-samples,389,1,107,removed,0,107,Samples/OCR/cpp/WordOverlay.h,high,1
Windows-universal-samples,382,1,35,modified,18,17,Samples/XamlNavigation/shared/AppShell.xaml,medium,1
Windows-universal-samples,381,1,2,modified,1,1,Samples/GlobalizationPreferences/README.md,low,1
Windows-universal-samples,378,3,67,modified,32,35,Samples/MessageDialog/cs/MessageDialogSample.sln,low,2
Windows-universal-samples,378,3,2,modified,1,1,Samples/MessageDialog/cs/project.json,medium,1
Windows-universal-samples,378,3,25,modified,13,12,SharedContent/cs/MainPage.xaml,medium,1
WindowsCommunityToolkit,2550,1,4,modified,2,2,readme.md,low,0
WindowsCommunityToolkit,2549,1,6,modified,0,6,Microsoft.Toolkit.Uwp.UI.Controls.Graph/AadLogin/AadLogin.Events.cs,high,0
WindowsCommunityToolkit,2549,1,20,modified,1,19,Microsoft.Toolkit.Uwp.UI.Controls.Graph/AadLogin/AadLogin.cs,high,0
WindowsCommunityToolkit,2548,1,12,modified,6,6,Microsoft.Toolkit.Win32/Microsoft.Toolkit.Win32.UI.XamlHost/UWPTypeFactory.cs,high,0
WindowsCommunityToolkit,2545,8,63,modified,43,20,Microsoft.Toolkit.Uwp.SampleApp/SamplePages/DataGrid/DataGridPage.xaml.cs,high,0
WindowsCommunityToolkit,2545,8,3,modified,3,0,Microsoft.Toolkit.Uwp.UI.Controls.DataGrid/DataGrid/DataGrid.cs,high,0
WindowsCommunityToolkit,2545,8,2,modified,1,1,Microsoft.Toolkit.Uwp.UI.Controls.DataGrid/DataGrid/DataGridCheckBoxColumn.cs,high,0
WindowsCommunityToolkit,2545,8,2,modified,1,1,Microsoft.Toolkit.Uwp.UI.Controls.DataGrid/DataGrid/DataGridColumns.cs,high,0
WindowsCommunityToolkit,2545,8,99,modified,59,40,Microsoft.Toolkit.Uwp.UI.Controls.DataGrid/DataGrid/DataGridComboBoxColumn.cs,high,0
WindowsCommunityToolkit,2545,8,29,modified,29,0,Microsoft.Toolkit.Uwp.UI.Controls.DataGrid/DataGrid/DataGridError.cs,high,0
WindowsCommunityToolkit,2545,8,10,modified,3,7,Microsoft.Toolkit.Uwp.UI.Controls.DataGrid/DataGrid/DataGridTextColumn.cs,high,0
WindowsCommunityToolkit,2544,17,1,modified,1,0,.gitignore,low,0
WindowsCommunityToolkit,2544,17,2,modified,1,1,Directory.Build.props,medium,0
WindowsCommunityToolkit,2544,17,13,modified,13,0,Microsoft.Toolkit.Uwp.SampleApp/Microsoft.Toolkit.Uwp.SampleApp.csproj,low,0
WindowsCommunityToolkit,2544,17,0,added,0,0,Microsoft.Toolkit.Uwp.SampleApp/SamplePages/DirectWriteTextBlock/DirectWriteTextBlock.png,low,0
WindowsCommunityToolkit,2544,17,27,added,27,0,Microsoft.Toolkit.Uwp.SampleApp/SamplePages/DirectWriteTextBlock/DirectWriteTextBlockCode.bind,medium,0
WindowsCommunityToolkit,2544,17,18,added,18,0,Microsoft.Toolkit.Uwp.SampleApp/SamplePages/DirectWriteTextBlock/DirectWriteTextBlockPage.xaml,medium,0
WindowsCommunityToolkit,2544,17,32,added,32,0,Microsoft.Toolkit.Uwp.SampleApp/SamplePages/DirectWriteTextBlock/DirectWriteTextBlockPage.xaml.cs,high,0
WindowsCommunityToolkit,2544,17,11,modified,11,0,Microsoft.Toolkit.Uwp.SampleApp/SamplePages/samples.json,medium,0
WindowsCommunityToolkit,2544,17,298,added,298,0,Microsoft.Toolkit.Uwp.UI.Controls.WinRT/DirectWriteTextBlock/DirectWriteRenderArgBuilder.cpp,high,0
WindowsCommunityToolkit,2544,17,120,added,120,0,Microsoft.Toolkit.Uwp.UI.Controls.WinRT/DirectWriteTextBlock/DirectWriteRenderArgBuilder.h,high,0
WindowsCommunityToolkit,2544,17,124,added,124,0,Microsoft.Toolkit.Uwp.UI.Controls.WinRT/DirectWriteTextBlock/DirectWriteResourceManager.cpp,high,0
WindowsCommunityToolkit,2544,17,55,added,55,0,Microsoft.Toolkit.Uwp.UI.Controls.WinRT/DirectWriteTextBlock/DirectWriteResourceManager.h,high,0
WindowsCommunityToolkit,2544,17,333,added,333,0,Microsoft.Toolkit.Uwp.UI.Controls.WinRT/DirectWriteTextBlock/DirectWriteTextBlock.cpp,high,0
WindowsCommunityToolkit,2544,17,114,added,114,0,Microsoft.Toolkit.Uwp.UI.Controls.WinRT/DirectWriteTextBlock/DirectWriteTextBlock.h,high,0
WindowsCommunityToolkit,2544,17,241,added,241,0,Microsoft.Toolkit.Uwp.UI.Controls.WinRT/Microsoft.Toolkit.Uwp.UI.Controls.WinRT.vcxproj,medium,0
WindowsCommunityToolkit,2544,17,57,added,57,0,Microsoft.Toolkit.Uwp.UI.Controls.WinRT/Microsoft.Toolkit.Uwp.UI.Controls.WinRT.vcxproj.filters,medium,0
WindowsCommunityToolkit,2544,17,34,added,34,0,Microsoft.Toolkit.Uwp.UI.Controls.WinRT/Themes/Generic.xaml,medium,0
WindowsCommunityToolkit,2544,17,107,added,107,0,Microsoft.Toolkit.Uwp.UI.Controls.WinRT/UniversalWindowsAppPackageFontLoader/FontCollectionLoader.cpp,high,0
WindowsCommunityToolkit,2544,17,60,added,60,0,Microsoft.Toolkit.Uwp.UI.Controls.WinRT/UniversalWindowsAppPackageFontLoader/FontCollectionLoader.h,high,0
WindowsCommunityToolkit,2544,17,70,added,70,0,Microsoft.Toolkit.Uwp.UI.Controls.WinRT/UniversalWindowsAppPackageFontLoader/FontFileEnumerator.cpp,high,0
WindowsCommunityToolkit,2544,17,42,added,42,0,Microsoft.Toolkit.Uwp.UI.Controls.WinRT/UniversalWindowsAppPackageFontLoader/FontFileEnumerator.h,high,0
WindowsCommunityToolkit,2544,17,14,added,14,0,Microsoft.Toolkit.Uwp.UI.Controls.WinRT/UniversalWindowsAppPackageFontLoader/UniversalPackageFontData.h,high,0
WindowsCommunityToolkit,2544,17,1,added,1,0,Microsoft.Toolkit.Uwp.UI.Controls.WinRT/pch.cpp,high,0
WindowsCommunityToolkit,2544,17,15,added,15,0,Microsoft.Toolkit.Uwp.UI.Controls.WinRT/pch.h,high,0
WindowsCommunityToolkit,2544,17,25,modified,25,0,Windows Community Toolkit.sln,low,0
WindowsCommunityToolkit,2544,17,53,added,53,0,docs/controls/DirectWriteTextBlock.md,low,0
WindowsCommunityToolkit,2538,3,47,modified,35,12,Microsoft.Toolkit.Win32/Microsoft.Toolkit.Wpf.UI.Controls.WebView/WebView.cs,high,0
WindowsCommunityToolkit,2536,9,79,modified,79,0,Microsoft.Toolkit.Uwp.UI.Controls.DataGrid/DataGrid/DataGrid.cs,high,0
WindowsCommunityToolkit,2535,21,41,added,41,0,Microsoft.Toolkit.Services/Services/MicrosoftTranslator/DetectedLanguage.cs,high,0
WindowsCommunityToolkit,2535,21,48,added,48,0,Microsoft.Toolkit.Services/Services/MicrosoftTranslator/DetectedLanguageBase.cs,high,0
WindowsCommunityToolkit,2535,21,36,added,36,0,Microsoft.Toolkit.Services/Services/MicrosoftTranslator/DetectedLanguageResponse.cs,high,0
WindowsCommunityToolkit,2535,21,285,modified,264,21,Microsoft.Toolkit.Services/Services/MicrosoftTranslator/ITranslatorService.cs,high,0
WindowsCommunityToolkit,2535,21,29,modified,24,5,Microsoft.Toolkit.Services/Services/MicrosoftTranslator/ServiceLanguage.cs,high,0
WindowsCommunityToolkit,2535,21,34,added,34,0,Microsoft.Toolkit.Services/Services/MicrosoftTranslator/Translation.cs,high,0
WindowsCommunityToolkit,2535,21,46,added,46,0,Microsoft.Toolkit.Services/Services/MicrosoftTranslator/TranslationResponse.cs,high,0
WindowsCommunityToolkit,2535,21,330,modified,122,208,Microsoft.Toolkit.Services/Services/MicrosoftTranslator/TranslatorService.cs,high,0
WindowsCommunityToolkit,2535,21,15,modified,12,3,Microsoft.Toolkit.Uwp.SampleApp/SamplePages/Microsoft Translator Service/MicrosoftTranslatorCode.bind,medium,0
WindowsCommunityToolkit,2535,21,76,modified,39,37,Microsoft.Toolkit.Uwp.SampleApp/SamplePages/Microsoft Translator Service/MicrosoftTranslatorPage.xaml,medium,0
WindowsCommunityToolkit,2535,21,11,modified,6,5,Microsoft.Toolkit.Uwp.SampleApp/SamplePages/Microsoft Translator Service/MicrosoftTranslatorPage.xaml.cs,high,0
WindowsCommunityToolkit,2535,21,8,modified,5,3,docs/services/MicrosoftTranslator.md,low,0
WindowsCommunityToolkit,2534,1,2,modified,1,1,Microsoft.Toolkit.Uwp.UI.Controls/Microsoft.Toolkit.Uwp.UI.Controls.csproj,low,0
WindowsCommunityToolkit,2533,6,3,modified,2,1,Microsoft.Toolkit.Uwp.SampleApp/SamplePages/Connected Animations/ConnectedAnimationsPage.xaml.cs,high,0
WindowsCommunityToolkit,2533,6,3,modified,2,1,Microsoft.Toolkit.Uwp.SampleApp/SamplePages/Connected Animations/Pages/FirstPage.xaml.cs,high,0
WindowsCommunityToolkit,2533,6,3,modified,2,1,Microsoft.Toolkit.Uwp.SampleApp/SamplePages/Connected Animations/Pages/SecondPage.xaml.cs,high,0
WindowsCommunityToolkit,2533,6,117,modified,91,26,Microsoft.Toolkit.Uwp.UI.Animations/ConnectedAnimations/Connected.cs,high,0
WindowsCommunityToolkit,2533,6,43,modified,37,6,Microsoft.Toolkit.Uwp.UI.Animations/ConnectedAnimations/ConnectedAnimationHelper.cs,high,0
WindowsCommunityToolkit,2531,2,0,removed,0,0,Microsoft.Toolkit.Uwp.PlatformSpecificAnalyzer/Differences-5.0.0.0.gz,NaN,0
WindowsCommunityToolkit,2531,2,0,added,0,0,Microsoft.Toolkit.Uwp.PlatformSpecificAnalyzer/Differences-7.0.0.0.gz,NaN,0
WindowsCommunityToolkit,2531,2,9,modified,7,2,Microsoft.Toolkit.Uwp.PlatformSpecificAnalyzer/Microsoft.Toolkit.Uwp.PlatformSpecificAnalyzer.csproj,low,0
WindowsCommunityToolkit,2529,6,1,modified,0,1,Microsoft.Toolkit.Uwp.SampleApp/SamplePages/MarkdownTextBlock/MarkdownTextBlock.bind,medium,0
WindowsCommunityToolkit,2529,6,13,modified,12,1,Microsoft.Toolkit.Uwp.UI.Controls/MarkdownTextBlock/MarkdownTextBlock.xaml,medium,0
WindowsCommunityToolkit,2528,7,4,modified,2,2,.github/ISSUE_TEMPLATE.md,low,0
WindowsCommunityToolkit,2528,7,4,modified,2,2,Directory.Build.props,medium,0
WindowsCommunityToolkit,2528,7,2,modified,1,1,Directory.Build.targets,low,0
WindowsCommunityToolkit,2528,7,2,modified,1,1,GazeInputTest/GazeInputTest.csproj,low,0
WindowsCommunityToolkit,2528,7,2,modified,1,1,Microsoft.Toolkit.Parsers/Microsoft.Toolkit.Parsers.csproj,low,0
WindowsCommunityToolkit,2528,7,8,modified,4,4,Microsoft.Toolkit.Services/Microsoft.Toolkit.Services.csproj,low,0
WindowsCommunityToolkit,2528,7,2,modified,1,1,Microsoft.Toolkit.Uwp.Connectivity/Microsoft.Toolkit.Uwp.Connectivity.csproj,low,0
WindowsCommunityToolkit,2528,7,2,modified,1,1,Microsoft.Toolkit.Uwp.DeveloperTools/Microsoft.Toolkit.Uwp.DeveloperTools.csproj,low,0
WindowsCommunityToolkit,2528,7,2,modified,1,1,Microsoft.Toolkit.Uwp.Input.GazeInteraction/Microsoft.Toolkit.UWP.Input.GazeInteraction.vcxproj,medium,0
WindowsCommunityToolkit,2528,7,2,modified,1,1,Microsoft.Toolkit.Uwp.Notifications/Microsoft.Toolkit.Uwp.Notifications.csproj,low,0
WindowsCommunityToolkit,2528,7,2,modified,1,1,Microsoft.Toolkit.Uwp.PlatformSpecificAnalyzer/Microsoft.Toolkit.Uwp.PlatformSpecificAnalyzer.csproj,low,0
WindowsCommunityToolkit,2528,7,4,modified,2,2,Microsoft.Toolkit.Uwp.SampleApp/Microsoft.Toolkit.Uwp.SampleApp.csproj,low,0
WindowsCommunityToolkit,2528,7,4,modified,2,2,Microsoft.Toolkit.Uwp.Samples.BackgroundTasks/Microsoft.Toolkit.Uwp.Samples.BackgroundTasks.csproj,low,0
WindowsCommunityToolkit,2528,7,2,modified,1,1,Microsoft.Toolkit.Uwp.Services/Microsoft.Toolkit.Uwp.Services.csproj,low,0
WindowsCommunityToolkit,2528,7,2,modified,1,1,Microsoft.Toolkit.Uwp.UI.Animations/Microsoft.Toolkit.Uwp.UI.Animations.csproj,low,0
WindowsCommunityToolkit,2528,7,12,modified,6,6,Microsoft.Toolkit.Uwp.UI.Controls.DataGrid.Design/Microsoft.Toolkit.Uwp.UI.Controls.DataGrid.Design.csproj,low,0
WindowsCommunityToolkit,2528,7,2,modified,1,1,Microsoft.Toolkit.Uwp.UI.Controls.DataGrid/Microsoft.Toolkit.Uwp.UI.Controls.DataGrid.csproj,low,0
WindowsCommunityToolkit,2528,7,12,modified,6,6,Microsoft.Toolkit.Uwp.UI.Controls.Design/Microsoft.Toolkit.Uwp.UI.Controls.Design.csproj,low,0
WindowsCommunityToolkit,2528,7,2,modified,1,1,Microsoft.Toolkit.Uwp.UI.Controls.Graph/Microsoft.Toolkit.Uwp.UI.Controls.Graph.csproj,low,0
WindowsCommunityToolkit,2528,7,4,modified,2,2,Microsoft.Toolkit.Uwp.UI.Controls/ImageEx/ImageExBase.Members.cs,high,0
WindowsCommunityToolkit,2528,7,2,modified,1,1,Microsoft.Toolkit.Uwp.UI.Controls/Microsoft.Toolkit.Uwp.UI.Controls.csproj,low,0
WindowsCommunityToolkit,2528,7,2,modified,1,1,Microsoft.Toolkit.Uwp.UI/Microsoft.Toolkit.Uwp.UI.csproj,low,0
WindowsCommunityToolkit,2528,7,2,modified,1,1,Microsoft.Toolkit.Uwp/Microsoft.Toolkit.Uwp.csproj,low,0
WindowsCommunityToolkit,2528,7,2,modified,1,1,Microsoft.Toolkit.Win32/Microsoft.Toolkit.Sample.Wpf.App/Microsoft.Toolkit.Sample.Wpf.App.csproj,low,0
WindowsCommunityToolkit,2528,7,2,modified,1,1,Microsoft.Toolkit.Win32/Microsoft.Toolkit.Sample.Wpf.WebView/Microsoft.Toolkit.Sample.Wpf.WebView.csproj,low,0
WindowsCommunityToolkit,2528,7,2,modified,1,1,Microsoft.Toolkit.Win32/Microsoft.Toolkit.Sample.Wpf.XamlHost/Microsoft.Toolkit.Sample.Wpf.XamlHost.csproj,low,0
WindowsCommunityToolkit,2528,7,5,modified,5,0,Microsoft.Toolkit.Win32/WebView.Shared/Interop/Windows10Release.cs,high,0
WindowsCommunityToolkit,2528,7,2,modified,1,1,Microsoft.Toolkit/Microsoft.Toolkit.csproj,low,0
WindowsCommunityToolkit,2528,7,4,modified,2,2,UnitTests/UnitTests.Notifications.UWP/UnitTests.Notifications.UWP.csproj,low,0
WindowsCommunityToolkit,2528,7,4,modified,2,2,UnitTests/UnitTests.Notifications.WinRT/UnitTests.Notifications.WinRT.csproj,low,0
WindowsCommunityToolkit,2527,5,5,modified,0,5,Microsoft.Toolkit.Uwp.UI.Controls/Expander/Expander.Constants.cs,high,0
WindowsCommunityToolkit,2527,5,14,modified,1,13,Microsoft.Toolkit.Uwp.UI.Controls/Expander/Expander.Properties.cs,high,0
WindowsCommunityToolkit,2527,5,40,modified,0,40,Microsoft.Toolkit.Uwp.UI.Controls/Expander/Expander.cs,high,0
WindowsCommunityToolkit,2527,5,88,modified,31,57,Microsoft.Toolkit.Uwp.UI.Controls/Expander/Expander.xaml,medium,0
WindowsCommunityToolkit,2526,6,2,modified,1,1,.github/PULL_REQUEST_TEMPLATE.md,low,0
WindowsCommunityToolkit,2526,6,4,modified,2,2,Microsoft.Toolkit.Uwp.SampleApp/Microsoft.Toolkit.Uwp.SampleApp.csproj,low,0
WindowsCommunityToolkit,2526,6,5,modified,2,3,Microsoft.Toolkit.Uwp.SampleApp/Models/Sample.cs,high,0
WindowsCommunityToolkit,2526,6,194,modified,97,97,Microsoft.Toolkit.Uwp.SampleApp/SamplePages/samples.json,medium,0
WindowsCommunityToolkit,2526,6,14,modified,11,3,Microsoft.Toolkit.Uwp.SampleApp/readme.md,low,0
WindowsCommunityToolkit,2526,6,15,modified,12,3,contributing.md,low,0
WindowsCommunityToolkit,2526,6,127,removed,0,127,docs/.template.md,low,0
WindowsCommunityToolkit,2526,6,47,removed,0,47,docs/Getting-Started.md,low,0
WindowsCommunityToolkit,2526,6,49,removed,0,49,docs/Nuget-Packages.md,low,0
WindowsCommunityToolkit,2526,6,34,removed,0,34,docs/Toolbox-Support.md,low,0
WindowsCommunityToolkit,2526,6,188,removed,0,188,docs/animations/AnimationSet.md,low,0
WindowsCommunityToolkit,2526,6,124,removed,0,124,docs/animations/Blur.md,low,0
WindowsCommunityToolkit,2526,6,163,removed,0,163,docs/animations/CompositionAnimations.md,low,0
WindowsCommunityToolkit,2526,6,143,removed,0,143,docs/animations/ConnectedAnimations.md,low,0
WindowsCommunityToolkit,2526,6,1140,removed,0,1140,docs/animations/Expressions.md,low,0
WindowsCommunityToolkit,2526,6,123,removed,0,123,docs/animations/Fade.md,low,0
WindowsCommunityToolkit,2526,6,98,removed,0,98,docs/animations/FadeHeader.md,low,0
WindowsCommunityToolkit,2526,6,139,removed,0,139,docs/animations/ImplicitAnimations.md,low,0
WindowsCommunityToolkit,2526,6,108,removed,0,108,docs/animations/Light.md,low,0
WindowsCommunityToolkit,2526,6,160,removed,0,160,docs/animations/Offset.md,low,0
WindowsCommunityToolkit,2526,6,95,removed,0,95,docs/animations/ParallaxService.md,low,0
WindowsCommunityToolkit,2526,6,53,removed,0,53,docs/animations/ReorderGrid.md,low,0
WindowsCommunityToolkit,2526,6,126,removed,0,126,docs/animations/Rotate.md,low,0
WindowsCommunityToolkit,2526,6,131,removed,0,131,docs/animations/Saturation.md,low,0
WindowsCommunityToolkit,2526,6,158,removed,0,158,docs/animations/Scale.md,low,0
WindowsCommunityToolkit,2526,6,11,removed,0,11,docs/breadcrumb/toc.yml,medium,0
WindowsCommunityToolkit,2526,6,50,removed,0,50,docs/brushes/BackdropBlurBrush.md,low,0
WindowsCommunityToolkit,2526,6,51,removed,0,51,docs/brushes/BackdropGammaTransferBrush.md,low,0
WindowsCommunityToolkit,2526,6,44,removed,0,44,docs/brushes/BackdropInvertBrush.md,low,0
WindowsCommunityToolkit,2526,6,49,removed,0,49,docs/brushes/BackdropSaturationBrush.md,low,0
WindowsCommunityToolkit,2525,6,2,modified,1,1,Microsoft.Toolkit.Win32/Microsoft.Toolkit.Forms.UI.Controls/WindowsXamlHostBaseExt.cs,high,0
WindowsCommunityToolkit,2525,6,119,added,119,0,Microsoft.Toolkit.Win32/Microsoft.Toolkit.Forms.UI.XamlHost/DpiScalingPanel.cs,high,0
WindowsCommunityToolkit,2525,6,1,modified,1,0,Microsoft.Toolkit.Win32/Microsoft.Toolkit.Forms.UI.XamlHost/Interop/Win32/NativeDefines.cs,high,0
WindowsCommunityToolkit,2525,6,9,modified,9,0,Microsoft.Toolkit.Win32/Microsoft.Toolkit.Forms.UI.XamlHost/Interop/Win32/SafeNativeMethods.cs,high,0
WindowsCommunityToolkit,2525,6,2,modified,1,1,Microsoft.Toolkit.Win32/Microsoft.Toolkit.Forms.UI.XamlHost/Microsoft.Toolkit.Forms.UI.XamlHost.csproj,low,0
WindowsCommunityToolkit,2525,6,2,modified,1,1,Microsoft.Toolkit.Win32/Microsoft.Toolkit.Forms.UI.XamlHost/WindowsXamlHost.cs,high,0
WindowsCommunityToolkit,2525,6,28,modified,25,3,Microsoft.Toolkit.Win32/Microsoft.Toolkit.Forms.UI.XamlHost/WindowsXamlHostBase.Layout.cs,high,0
WindowsCommunityToolkit,2525,6,9,modified,9,0,Microsoft.Toolkit.Win32/Microsoft.Toolkit.Forms.UI.XamlHost/WindowsXamlHostBase.WndProc.cs,high,0
WindowsCommunityToolkit,2525,6,47,modified,39,8,Microsoft.Toolkit.Win32/Microsoft.Toolkit.Forms.UI.XamlHost/WindowsXamlHostBase.cs,high,0
WindowsCommunityToolkit,2525,6,2,modified,2,0,Microsoft.Toolkit.Win32/Microsoft.Toolkit.Win32.UI.Controls/Interop/Win32/WM.cs,high,0
WindowsCommunityToolkit,2524,0,67,modified,33,34,Microsoft.Toolkit/Extensions/ArrayExtensions.cs,high,0
WindowsCommunityToolkit,2524,0,74,modified,43,31,Microsoft.Toolkit/Extensions/StringExtensions.cs,high,0
WindowsCommunityToolkit,2524,0,21,modified,7,14,docs/extensions/ArrayExtensions.md,low,0
WindowsCommunityToolkit,2524,0,24,modified,12,12,docs/extensions/StringExtensions.md,low,0
WindowsCommunityToolkit,2523,7,581,modified,261,320,Microsoft.Toolkit.Uwp.UI.Controls/Expander/Expander.xaml,medium,0
WindowsCommunityToolkit,2522,16,149,modified,146,3,Microsoft.Toolkit.Uwp.UI.Controls/RadialGauge/RadialGauge.cs,high,0
WindowsCommunityToolkit,2522,16,21,modified,14,7,Microsoft.Toolkit.Uwp.UI.Controls/RadialGauge/RadialGauge.xaml,medium,0
WindowsCommunityToolkit,2522,16,82,added,82,0,Microsoft.Toolkit.Uwp.UI.Controls/RadialGauge/RadialGaugeAutomationPeer.cs,high,0
WindowsCommunityToolkit,2521,0,48,modified,23,25,readme.md,low,0
WindowsCommunityToolkit,2520,4,16,modified,9,7,Microsoft.Toolkit.Uwp.SampleApp/SamplePages/InAppNotification/InAppNotificationXaml.bind,medium,0
WindowsCommunityToolkit,2520,4,39,modified,5,34,Microsoft.Toolkit.Uwp.UI.Controls/InAppNotification/InAppNotification.xaml,medium,0
WindowsCommunityToolkit,2520,4,50,modified,40,10,Microsoft.Toolkit.Uwp.UI.Controls/InAppNotification/Styles/VSCodeNotificationStyle.xaml,medium,0
WindowsCommunityToolkit,2519,15,19,removed,0,19,.vsts-ci.yml,medium,1
WindowsCommunityToolkit,2519,15,6,removed,0,6,.vsts-pr.yml,medium,1
WindowsCommunityToolkit,2519,15,2,modified,1,1,Directory.Build.props,medium,1
WindowsCommunityToolkit,2519,15,16,modified,9,7,Microsoft.Toolkit.Uwp.SampleApp/SamplePages/InAppNotification/InAppNotificationXaml.bind,medium,1
WindowsCommunityToolkit,2519,15,11,modified,2,9,Microsoft.Toolkit.Uwp.UI.Controls/InAppNotification/InAppNotification.xaml,medium,1
WindowsCommunityToolkit,2519,15,50,modified,40,10,Microsoft.Toolkit.Uwp.UI.Controls/InAppNotification/Styles/VSCodeNotificationStyle.xaml,medium,1
WindowsCommunityToolkit,2519,15,7,modified,7,0,Microsoft.Toolkit.Win32/Microsoft.Toolkit.Win32.UI.Controls/IWebView.cs,high,1
WindowsCommunityToolkit,2519,15,146,modified,0,146,Microsoft.Toolkit.Win32/Microsoft.Toolkit.Win32.UI.Controls/Interop/Win32/DpiHelper.cs,high,1
WindowsCommunityToolkit,2519,15,51,modified,0,51,Microsoft.Toolkit.Win32/Microsoft.Toolkit.Win32.UI.Controls/Interop/Win32/UnsafeNativeMethods.cs,high,1
WindowsCommunityToolkit,2519,15,6,modified,3,3,Microsoft.Toolkit.Win32/Microsoft.Toolkit.Win32.UI.Controls/Interop/WinRT/WebViewControlHost.cs,high,1
WindowsCommunityToolkit,2519,15,4,modified,2,2,Microsoft.Toolkit.Win32/Microsoft.Toolkit.Win32.UI.Controls/Microsoft.Toolkit.Win32.UI.Controls.csproj,low,1
WindowsCommunityToolkit,2519,15,27,modified,14,13,Microsoft.Toolkit.Win32/Microsoft.Toolkit.Win32.UI.Controls/WPF/WebView/WebView.cs,high,1
WindowsCommunityToolkit,2519,15,22,modified,14,8,Microsoft.Toolkit.Win32/Microsoft.Toolkit.Win32.UI.Controls/WPF/WebView/WebViewHost.cs,high,1
WindowsCommunityToolkit,2519,15,8,modified,6,2,Microsoft.Toolkit.Win32/Microsoft.Toolkit.Win32.UI.Controls/WinForms/WebView/WebView.cs,high,1
WindowsCommunityToolkit,2519,15,12,modified,5,7,Microsoft.Toolkit.Win32/Tests/UnitTests.WebView.WinForms/FunctionalTests/PreLoad/PreLoadTests.cs,high,1
WindowsCommunityToolkit,2519,15,23,renamed,19,4,azure-pipelines.yml,medium,1
WindowsCommunityToolkit,2519,15,2,modified,1,1,version.json,medium,1
WindowsCommunityToolkit,2517,6,50,modified,36,14,Microsoft.Toolkit.Uwp.UI.Controls.DataGrid/DataGrid/DataGrid.xaml,medium,0
WindowsCommunityToolkit,2516,2,8,modified,8,0,Microsoft.Toolkit.Uwp.UI.Controls/InfiniteCanvas/InfiniteCanvas.cs,high,0
WindowsCommunityToolkit,2515,52,22,added,22,0,Microsoft.Toolkit.Services/Services/Weibo/WeiboDataConfig.cs,high,0
WindowsCommunityToolkit,2515,52,420,added,420,0,Microsoft.Toolkit.Services/Services/Weibo/WeiboDataProvider.cs,high,0
WindowsCommunityToolkit,2515,52,26,added,26,0,Microsoft.Toolkit.Services/Services/Weibo/WeiboError.cs,high,0
WindowsCommunityToolkit,2515,52,19,added,19,0,Microsoft.Toolkit.Services/Services/Weibo/WeiboException.cs,high,0
WindowsCommunityToolkit,2515,52,38,added,38,0,Microsoft.Toolkit.Services/Services/Weibo/WeiboGeoInfo.cs,high,0
WindowsCommunityToolkit,2515,52,32,added,32,0,Microsoft.Toolkit.Services/Services/Weibo/WeiboImage.cs,high,0
WindowsCommunityToolkit,2515,52,194,added,194,0,Microsoft.Toolkit.Services/Services/Weibo/WeiboOAuthRequest.cs,high,0
WindowsCommunityToolkit,2515,52,41,added,41,0,Microsoft.Toolkit.Services/Services/Weibo/WeiboOAuthRequestExtensions.cs,high,0
WindowsCommunityToolkit,2515,52,32,added,32,0,Microsoft.Toolkit.Services/Services/Weibo/WeiboOAuthTokens.cs,high,0
WindowsCommunityToolkit,2515,52,41,added,41,0,Microsoft.Toolkit.Services/Services/Weibo/WeiboParser.cs,high,0
WindowsCommunityToolkit,2515,52,28,added,28,0,Microsoft.Toolkit.Services/Services/Weibo/WeiboQueryType.cs,high,0
WindowsCommunityToolkit,2515,52,284,added,284,0,Microsoft.Toolkit.Services/Services/Weibo/WeiboService.cs,high,0
WindowsCommunityToolkit,2515,52,143,added,143,0,Microsoft.Toolkit.Services/Services/Weibo/WeiboStatus.cs,high,0
WindowsCommunityToolkit,2515,52,47,added,47,0,Microsoft.Toolkit.Services/Services/Weibo/WeiboStatusParser.cs,high,0
WindowsCommunityToolkit,2515,52,92,added,92,0,Microsoft.Toolkit.Services/Services/Weibo/WeiboUser.cs,high,0
WindowsCommunityToolkit,2515,52,9,modified,9,0,Microsoft.Toolkit.Uwp.SampleApp/Microsoft.Toolkit.Uwp.SampleApp.csproj,low,0
WindowsCommunityToolkit,2515,52,24,added,24,0,Microsoft.Toolkit.Uwp.SampleApp/SamplePages/Weibo Service/WeiboCode.bind,medium,0
WindowsCommunityToolkit,2515,52,0,added,0,0,Microsoft.Toolkit.Uwp.SampleApp/SamplePages/Weibo Service/WeiboLogo.png,low,0
WindowsCommunityToolkit,2515,52,234,added,234,0,Microsoft.Toolkit.Uwp.SampleApp/SamplePages/Weibo Service/WeiboPage.xaml,medium,0
WindowsCommunityToolkit,2515,52,175,added,175,0,Microsoft.Toolkit.Uwp.SampleApp/SamplePages/Weibo Service/WeiboPage.xaml.cs,high,0
WindowsCommunityToolkit,2515,52,9,modified,9,0,Microsoft.Toolkit.Uwp.SampleApp/SamplePages/samples.json,medium,0
WindowsCommunityToolkit,2513,3,28,modified,18,10,Microsoft.Toolkit.Uwp/Helpers/PrintHelper/PrintHelper.cs,high,0
WindowsCommunityToolkit,2513,3,13,modified,8,5,Microsoft.Toolkit.Uwp/Helpers/PrintHelper/PrintHelperStateBag.cs,high,0
WindowsCommunityToolkit,2505,1,7,modified,7,0,Microsoft.Toolkit.Win32/Microsoft.Toolkit.Win32.UI.Controls/IWebView.cs,high,1
WindowsCommunityToolkit,2505,1,6,modified,3,3,Microsoft.Toolkit.Win32/Microsoft.Toolkit.Win32.UI.Controls/Interop/WinRT/WebViewControlHost.cs,high,1
WindowsCommunityToolkit,2505,1,8,modified,6,2,Microsoft.Toolkit.Win32/Microsoft.Toolkit.Win32.UI.Controls/WPF/WebView/WebView.cs,high,1
WindowsCommunityToolkit,2505,1,8,modified,6,2,Microsoft.Toolkit.Win32/Microsoft.Toolkit.Win32.UI.Controls/WinForms/WebView/WebView.cs,high,1
WindowsCommunityToolkit,2505,1,12,modified,5,7,Microsoft.Toolkit.Win32/Tests/UnitTests.WebView.WinForms/FunctionalTests/PreLoad/PreLoadTests.cs,high,1
WindowsCommunityToolkit,2504,1,4,modified,2,2,Directory.Build.props,medium,1
WindowsCommunityToolkit,2504,1,2,modified,1,1,azure-pipelines.yml,medium,1
WindowsCommunityToolkit,2502,2,1,modified,1,0,Microsoft.Toolkit.Win32/Microsoft.Toolkit.Forms.UI.XamlHost/Interop/Win32/NativeDefines.cs,high,0
WindowsCommunityToolkit,2502,2,2,modified,1,1,Microsoft.Toolkit.Win32/Microsoft.Toolkit.Forms.UI.XamlHost/WindowsXamlHostBase.cs,high,0
WindowsCommunityToolkit,2501,8,155,added,155,0,build/Find-WindowsSDKVersions.ps1,high,0
WindowsCommunityToolkit,2501,8,2,modified,2,0,build/build.cake,NaN,0
WindowsCommunityToolkit,2499,7,4,modified,4,0,Microsoft.Toolkit.Uwp.Notifications/Microsoft.Toolkit.Uwp.Notifications.csproj,low,0
WindowsCommunityToolkit,2499,7,110,added,110,0,Microsoft.Toolkit.Uwp.Notifications/Tiles/Builder/TileContentBuilder.SpecialTiles.cs,high,0
WindowsCommunityToolkit,2499,7,397,added,397,0,Microsoft.Toolkit.Uwp.Notifications/Tiles/Builder/TileContentBuilder.cs,high,0
WindowsCommunityToolkit,2499,7,13,modified,8,5,Microsoft.Toolkit.Uwp.Notifications/Tiles/TileCommon.cs,high,0
WindowsCommunityToolkit,2499,7,131,added,131,0,Microsoft.Toolkit.Uwp.Notifications/Toasts/Builder/ToastContentBuilder.Actions.cs,high,0
WindowsCommunityToolkit,2499,7,348,added,348,0,Microsoft.Toolkit.Uwp.Notifications/Toasts/Builder/ToastContentBuilder.Visuals.cs,high,0
WindowsCommunityToolkit,2499,7,87,added,87,0,Microsoft.Toolkit.Uwp.Notifications/Toasts/Builder/ToastContentBuilder.cs,high,0
WindowsCommunityToolkit,2497,3,10,modified,9,1,Microsoft.Toolkit.Win32/Microsoft.Toolkit.Forms.UI.XamlHost/WindowsXamlHostBase.WndProc.cs,high,0
WindowsCommunityToolkit,2496,1,146,modified,0,146,Microsoft.Toolkit.Win32/Microsoft.Toolkit.Win32.UI.Controls/Interop/Win32/DpiHelper.cs,high,1
WindowsCommunityToolkit,2496,1,51,modified,0,51,Microsoft.Toolkit.Win32/Microsoft.Toolkit.Win32.UI.Controls/Interop/Win32/UnsafeNativeMethods.cs,high,1
WindowsCommunityToolkit,2496,1,19,modified,8,11,Microsoft.Toolkit.Win32/Microsoft.Toolkit.Win32.UI.Controls/WPF/WebView/WebView.cs,high,1
WindowsCommunityToolkit,2496,1,22,modified,14,8,Microsoft.Toolkit.Win32/Microsoft.Toolkit.Win32.UI.Controls/WPF/WebView/WebViewHost.cs,high,1
WindowsCommunityToolkit,2495,1,146,modified,0,146,Microsoft.Toolkit.Win32.UI.Controls/Interop/Win32/DpiHelper.cs,high,0
WindowsCommunityToolkit,2495,1,51,modified,0,51,Microsoft.Toolkit.Win32.UI.Controls/Interop/Win32/UnsafeNativeMethods.cs,high,0
WindowsCommunityToolkit,2495,1,19,modified,8,11,Microsoft.Toolkit.Win32.UI.Controls/WPF/WebView/WebView.cs,high,0
WindowsCommunityToolkit,2495,1,22,modified,14,8,Microsoft.Toolkit.Win32.UI.Controls/WPF/WebView/WebViewHost.cs,high,0
WindowsCommunityToolkit,2494,1,4,modified,4,0,Microsoft.Toolkit.Win32/Microsoft.Toolkit.Win32.UI.XamlHost/MetadataProviderDiscovery.cs,high,0
WindowsCommunityToolkit,2490,32,60,added,60,0,docs/controls/wpf-winforms/InkCanvas.md,low,0
WindowsCommunityToolkit,2490,32,87,added,87,0,docs/controls/wpf-winforms/InkToolbar.md,low,0
WindowsCommunityToolkit,2490,32,83,added,83,0,docs/controls/wpf-winforms/MediaPlayerElement.md,low,0
WindowsCommunityToolkit,2490,32,0,renamed,0,0,docs/controls/wpf-winforms/WebView-known-issues.md,low,0
WindowsCommunityToolkit,2490,32,42,renamed,23,19,docs/controls/wpf-winforms/WebView.md,low,0
WindowsCommunityToolkit,2490,32,61,renamed,32,29,docs/controls/wpf-winforms/WebViewCompatible.md,low,0
WindowsCommunityToolkit,2490,32,114,renamed,74,40,docs/controls/wpf-winforms/WindowsXamlHost.md,low,0
WindowsCommunityToolkit,2490,32,70,removed,0,70,docs/modernization/InkCanvas.md,low,0
WindowsCommunityToolkit,2490,32,94,removed,0,94,docs/modernization/InkToolbar.md,low,0
WindowsCommunityToolkit,2490,32,84,removed,0,84,docs/modernization/MediaPlayerElement.md,low,0
WindowsCommunityToolkit,2490,32,0,modified,0,0,docs/resources/images/Controls/WindowsXAMLHost/type-name-property-windows-forms.png,low,0
WindowsCommunityToolkit,2490,32,0,modified,0,0,docs/resources/images/Controls/WindowsXAMLHost/xaml-content-updated-event-windows-forms.png,low,0
WindowsCommunityToolkit,2490,32,0,modified,0,0,docs/resources/images/Controls/WindowsXAMLHost/xaml-content-updated-event-wpf.png,low,0
WindowsCommunityToolkit,2490,32,11,modified,8,3,docs/toc.md,low,0
WindowsCommunityToolkit,2488,1,1,modified,1,0,Microsoft.Toolkit.Win32/Microsoft.Toolkit.Wpf.UI.Controls.WebView/VisualStudioToolsManifest.xml,medium,0
WindowsCommunityToolkit,2486,0,23,added,23,0,Microsoft.Toolkit.Uwp.UI.Controls/ImageEx/CachingStrategy.cs,high,0
WindowsCommunityToolkit,2486,0,14,modified,14,0,Microsoft.Toolkit.Uwp.UI.Controls/ImageEx/ImageExBase.Members.cs,high,0
WindowsCommunityToolkit,2486,0,110,modified,64,46,Microsoft.Toolkit.Uwp.UI.Controls/ImageEx/ImageExBase.Source.cs,high,0
WindowsCommunityToolkit,2486,0,4,modified,3,1,docs/controls/ImageEx.md,low,0
WindowsCommunityToolkit,2485,29,14,modified,14,0,Microsoft.Toolkit.Uwp.SampleApp/Data/DataGridDataSource.cs,high,0
WindowsCommunityToolkit,2485,29,8,modified,4,4,Microsoft.Toolkit.Uwp.SampleApp/Microsoft.Toolkit.Uwp.SampleApp.csproj,low,0
WindowsCommunityToolkit,2485,29,2,modified,1,1,Microsoft.Toolkit.Uwp.SampleApp/SamplePages/DataGrid/DataGridCode.bind,medium,0
WindowsCommunityToolkit,2485,29,3,modified,2,1,Microsoft.Toolkit.Uwp.SampleApp/SamplePages/DataGrid/DataGridPage.xaml,medium,0
WindowsCommunityToolkit,2485,29,8,modified,8,0,Microsoft.Toolkit.Uwp.SampleApp/SamplePages/DataGrid/DataGridPage.xaml.cs,high,0
WindowsCommunityToolkit,2485,29,5,modified,5,0,Microsoft.Toolkit.Uwp.UI.Controls.DataGrid/DataGrid/Automation/DataGridCellAutomationPeer.cs,high,0
WindowsCommunityToolkit,2485,29,622,added,622,0,Microsoft.Toolkit.Uwp.UI.Controls.DataGrid/DataGrid/DataGridComboBoxColumn.cs,high,0
WindowsCommunityToolkit,2481,11,45,modified,38,7,Microsoft.Toolkit.Win32/Microsoft.Toolkit.Forms.UI.XamlHost/WindowsXamlHostBase.KeyboardFocus.cs,high,0
WindowsCommunityToolkit,2480,2,105,modified,96,9,Microsoft.Toolkit.Win32/Microsoft.Toolkit.Win32.UI.XamlHost/MetadataProviderDiscovery.cs,high,0
WindowsCommunityToolkit,2480,2,8,modified,7,1,Microsoft.Toolkit.Win32/Microsoft.Toolkit.Win32.UI.XamlHost/XamlApplication.cs,high,0
WindowsCommunityToolkit,2479,2,7,modified,3,4,Directory.Build.props,medium,1
WindowsCommunityToolkit,2479,2,4,modified,2,2,Microsoft.Toolkit.Win32/Microsoft.Toolkit.Wpf.UI.Controls.WebView/WebViewCompatible.cs,high,0
WindowsCommunityToolkit,2479,2,2,modified,1,1,azure-pipelines.yml,medium,1
WindowsCommunityToolkit,2472,6,2,modified,1,1,Microsoft.Toolkit.Uwp.UI.Controls.DataGrid/DataGrid/DataGridColumns.cs,high,0
WindowsCommunityToolkit,2470,1,3,renamed,2,1,azure-pipelines.yml,medium,1
WindowsCommunityToolkit,2467,9,14,added,14,0,Microsoft.Toolkit.Win32/Microsoft.Toolkit.Forms.UI.Controls.WebView/IWebViewCompatibleAdapter.cs,high,0
WindowsCommunityToolkit,2467,9,52,added,52,0,Microsoft.Toolkit.Win32/Microsoft.Toolkit.Forms.UI.Controls.WebView/WebBaseCompatibilityAdapter.cs,high,0
WindowsCommunityToolkit,2467,9,82,added,82,0,Microsoft.Toolkit.Win32/Microsoft.Toolkit.Forms.UI.Controls.WebView/WebBrowserCompatibilityAdapter.cs,high,0
WindowsCommunityToolkit,2467,9,111,added,111,0,Microsoft.Toolkit.Win32/Microsoft.Toolkit.Forms.UI.Controls.WebView/WebViewCompatibilityAdapter.cs,high,0
WindowsCommunityToolkit,2467,9,88,added,88,0,Microsoft.Toolkit.Win32/Microsoft.Toolkit.Forms.UI.Controls.WebView/WebViewCompatible.cs,high,0
WindowsCommunityToolkit,2467,9,29,added,29,0,Microsoft.Toolkit.Win32/Microsoft.Toolkit.Forms.UI.Controls/InkCanvas/InkCanvas.cs,high,0
WindowsCommunityToolkit,2467,9,206,added,206,0,Microsoft.Toolkit.Win32/Microsoft.Toolkit.Forms.UI.Controls/InkToolbar/InkToolbar.cs,high,0
WindowsCommunityToolkit,2467,9,96,added,96,0,Microsoft.Toolkit.Win32/Microsoft.Toolkit.Forms.UI.Controls/InkToolbar/InkToolbarCustomPenButton.cs,high,0
WindowsCommunityToolkit,2467,9,58,added,58,0,Microsoft.Toolkit.Win32/Microsoft.Toolkit.Forms.UI.Controls/InkToolbar/InkToolbarCustomToolButton.cs,high,0
WindowsCommunityToolkit,2467,9,31,added,31,0,Microsoft.Toolkit.Win32/Microsoft.Toolkit.Forms.UI.Controls/InkToolbar/InkToolbarDesigner.cs,high,0
WindowsCommunityToolkit,2467,9,49,added,49,0,Microsoft.Toolkit.Win32/Microsoft.Toolkit.Forms.UI.Controls/InkToolbar/InkToolbarIsStencilButtonCheckedChangedEventArgs.cs,high,0
WindowsCommunityToolkit,2467,9,102,added,102,0,Microsoft.Toolkit.Win32/Microsoft.Toolkit.Forms.UI.Controls/InkToolbar/InkToolbarMenuButton.cs,high,0
WindowsCommunityToolkit,2467,9,83,added,83,0,Microsoft.Toolkit.Win32/Microsoft.Toolkit.Forms.UI.Controls/InkToolbar/InkToolbarPenButton.cs,high,0
WindowsCommunityToolkit,2467,9,73,added,73,0,Microsoft.Toolkit.Win32/Microsoft.Toolkit.Forms.UI.Controls/InkToolbar/InkToolbarStencilButton.cs,high,0
WindowsCommunityToolkit,2467,9,102,added,102,0,Microsoft.Toolkit.Win32/Microsoft.Toolkit.Forms.UI.Controls/InkToolbar/InkToolbarToggleButton.cs,high,0
WindowsCommunityToolkit,2467,9,53,added,53,0,Microsoft.Toolkit.Win32/Microsoft.Toolkit.Forms.UI.Controls/InkToolbar/InkToolbarToolButton.cs,high,0
WindowsCommunityToolkit,2467,9,29,added,29,0,Microsoft.Toolkit.Win32/Microsoft.Toolkit.Forms.UI.Controls/InkToolbar/InkToolbarToolButtonDesigner.cs,high,0
WindowsCommunityToolkit,2467,9,789,added,789,0,Microsoft.Toolkit.Win32/Microsoft.Toolkit.Forms.UI.Controls/MapControl/MapControl.cs,high,0
WindowsCommunityToolkit,2467,9,122,added,122,0,Microsoft.Toolkit.Win32/Microsoft.Toolkit.Forms.UI.Controls/MediaPlayerElement/MediaPlayerElement.cs,high,0
WindowsCommunityToolkit,2467,9,27,added,27,0,Microsoft.Toolkit.Win32/Microsoft.Toolkit.Forms.UI.Controls/MediaPlayerElement/MediaPlayerElementDesigner.cs,high,0
WindowsCommunityToolkit,2467,9,70,added,70,0,Microsoft.Toolkit.Win32/Microsoft.Toolkit.Forms.UI.Controls/SwapChainPanel/SwapChainPanel.cs,high,0
WindowsCommunityToolkit,2467,9,23,modified,16,7,Microsoft.Toolkit.Win32/Microsoft.Toolkit.Forms.UI.Controls/WindowsXamlHostBaseExt.cs,high,0
WindowsCommunityToolkit,2467,9,9,added,9,0,Microsoft.Toolkit.Win32/Microsoft.Toolkit.Sample.Forms.App/App.config,medium,0
WindowsCommunityToolkit,2467,9,199,added,199,0,Microsoft.Toolkit.Win32/Microsoft.Toolkit.Sample.Forms.App/Form1.Designer.cs,high,0
WindowsCommunityToolkit,2467,9,30,added,30,0,Microsoft.Toolkit.Win32/Microsoft.Toolkit.Sample.Forms.App/Form1.cs,high,0
WindowsCommunityToolkit,2467,9,120,added,120,0,Microsoft.Toolkit.Win32/Microsoft.Toolkit.Sample.Forms.App/Form1.resx,medium,0
WindowsCommunityToolkit,2467,9,109,added,109,0,Microsoft.Toolkit.Win32/Microsoft.Toolkit.Sample.Forms.App/Microsoft.Toolkit.Sample.Forms.App.csproj,low,0
WindowsCommunityToolkit,2467,9,26,added,26,0,Microsoft.Toolkit.Win32/Microsoft.Toolkit.Sample.Forms.App/Program.cs,high,0
WindowsCommunityToolkit,2467,9,29,added,29,0,Microsoft.Toolkit.Win32/Microsoft.Toolkit.Sample.Forms.App/Properties/AssemblyInfo.cs,high,0
WindowsCommunityToolkit,2467,9,71,added,71,0,Microsoft.Toolkit.Win32/Microsoft.Toolkit.Sample.Forms.App/Properties/Resources.Designer.cs,high,0
WindowsCommunityToolkit,2465,1,2,modified,1,1,readme.md,low,0
WindowsCommunityToolkit,2464,1,20,renamed,17,3,.azure-pipelines.yml,medium,0
WindowsCommunityToolkit,2464,1,19,removed,0,19,.vsts-ci.yml,medium,1
WindowsCommunityToolkit,2464,1,6,removed,0,6,.vsts-pr.yml,medium,1
WindowsCommunityToolkit,2462,22,3,modified,3,0,Microsoft.Toolkit.Uwp.Input.GazeInteraction/DwellProgressState.h,high,0
WindowsCommunityToolkit,2462,22,3,modified,3,0,Microsoft.Toolkit.Uwp.Input.GazeInteraction/GazeFeedbackPopupFactory.cpp,high,0
WindowsCommunityToolkit,2462,22,3,modified,3,0,Microsoft.Toolkit.Uwp.Input.GazeInteraction/GazeFeedbackPopupFactory.h,high,0
WindowsCommunityToolkit,2462,22,152,added,152,0,Microsoft.Toolkit.Uwp.Input.GazeInteraction/GazeHidParsers.cpp,high,0
WindowsCommunityToolkit,2462,22,74,added,74,0,Microsoft.Toolkit.Uwp.Input.GazeInteraction/GazeHidParsers.h,high,0
WindowsCommunityToolkit,2462,22,59,added,59,0,Microsoft.Toolkit.Uwp.Input.GazeInteraction/GazeHidUsages.h,high,0
WindowsCommunityToolkit,2462,22,3,modified,3,0,Microsoft.Toolkit.Uwp.Input.GazeInteraction/GazePointerProxy.cpp,high,0
WindowsCommunityToolkit,2462,22,9,modified,6,3,Microsoft.Toolkit.Uwp.Input.GazeInteraction/GazePointerProxy.h,high,0
WindowsCommunityToolkit,2462,22,3,modified,3,0,Microsoft.Toolkit.Uwp.Input.GazeInteraction/Microsoft.Toolkit.UWP.Input.GazeInteraction.vcxproj,medium,0
WindowsCommunityToolkit,2462,22,9,modified,9,0,Microsoft.Toolkit.Uwp.Input.GazeInteraction/Microsoft.Toolkit.UWP.Input.GazeInteraction.vcxproj.filters,medium,0
WindowsCommunityToolkit,2455,3,48,added,48,0,Microsoft.Toolkit.Win32/Microsoft.Toolkit.Forms.UI.Controls.WebView/Microsoft.Toolkit.Forms.UI.Controls.WebView.csproj,low,0
WindowsCommunityToolkit,2455,3,13,added,13,0,Microsoft.Toolkit.Win32/Microsoft.Toolkit.Forms.UI.Controls.WebView/Properties/AssemblyInfo.cs,high,0
WindowsCommunityToolkit,2455,3,0,renamed,0,0,Microsoft.Toolkit.Win32/Microsoft.Toolkit.Forms.UI.Controls.WebView/TaskExtensions.cs,high,0
WindowsCommunityToolkit,2455,3,0,renamed,0,0,Microsoft.Toolkit.Win32/Microsoft.Toolkit.Forms.UI.Controls.WebView/WebView.BaseProperties.cs,high,0
WindowsCommunityToolkit,2455,3,0,renamed,0,0,Microsoft.Toolkit.Win32/Microsoft.Toolkit.Forms.UI.Controls.WebView/WebView.Events.cs,high,0
WindowsCommunityToolkit,2455,3,0,renamed,0,0,Microsoft.Toolkit.Win32/Microsoft.Toolkit.Forms.UI.Controls.WebView/WebView.Init.cs,high,0
WindowsCommunityToolkit,2455,3,0,renamed,0,0,Microsoft.Toolkit.Win32/Microsoft.Toolkit.Forms.UI.Controls.WebView/WebView.Navigation.cs,high,0
WindowsCommunityToolkit,2455,3,0,renamed,0,0,Microsoft.Toolkit.Win32/Microsoft.Toolkit.Forms.UI.Controls.WebView/WebView.cs,high,0
WindowsCommunityToolkit,2455,3,0,renamed,0,0,Microsoft.Toolkit.Win32/Microsoft.Toolkit.Forms.UI.Controls.WebView/WebViewControlHostExtensions.cs,high,0
WindowsCommunityToolkit,2455,3,0,renamed,0,0,Microsoft.Toolkit.Win32/Microsoft.Toolkit.Forms.UI.Controls.WebView/WebViewControlProcessExtensions.cs,high,0
WindowsCommunityToolkit,2455,3,0,renamed,0,0,Microsoft.Toolkit.Win32/Microsoft.Toolkit.Forms.UI.Controls.WebView/WebViewDesigner.cs,high,0
WindowsCommunityToolkit,2455,3,27,modified,5,22,Microsoft.Toolkit.Win32/Microsoft.Toolkit.Forms.UI.Controls/Microsoft.Toolkit.Forms.UI.Controls.csproj,low,0
WindowsCommunityToolkit,2455,3,24,modified,12,12,Microsoft.Toolkit.Win32/Microsoft.Toolkit.Sample.Forms.WebView/Form1.Designer.cs,high,0
WindowsCommunityToolkit,2455,3,6,modified,3,3,Microsoft.Toolkit.Win32/Microsoft.Toolkit.Sample.Forms.WebView/Microsoft.Toolkit.Sample.Forms.WebView.csproj,low,0
WindowsCommunityToolkit,2455,3,9,modified,5,4,Microsoft.Toolkit.Win32/Microsoft.Toolkit.Sample.Wpf.App/MainWindow.xaml,medium,0
WindowsCommunityToolkit,2455,3,4,modified,4,0,Microsoft.Toolkit.Win32/Microsoft.Toolkit.Sample.Wpf.App/Microsoft.Toolkit.Sample.Wpf.App.csproj,low,0
WindowsCommunityToolkit,2455,3,5,modified,3,2,Microsoft.Toolkit.Win32/Microsoft.Toolkit.Sample.Wpf.WebView/MainWindow.xaml,medium,0
WindowsCommunityToolkit,2455,3,6,modified,3,3,Microsoft.Toolkit.Win32/Microsoft.Toolkit.Sample.Wpf.WebView/Microsoft.Toolkit.Sample.Wpf.WebView.csproj,low,0
WindowsCommunityToolkit,2455,3,14,modified,14,0,Microsoft.Toolkit.Win32/Microsoft.Toolkit.Win32.sln,low,0
WindowsCommunityToolkit,2455,3,0,renamed,0,0,Microsoft.Toolkit.Win32/Microsoft.Toolkit.Wpf.UI.Controls.WebView/DispatcherExtensions.cs,high,0
WindowsCommunityToolkit,2455,3,1,renamed,1,0,Microsoft.Toolkit.Win32/Microsoft.Toolkit.Wpf.UI.Controls.WebView/IWebViewCompatibleAdapter.cs,high,0
WindowsCommunityToolkit,2455,3,63,added,63,0,Microsoft.Toolkit.Win32/Microsoft.Toolkit.Wpf.UI.Controls.WebView/Microsoft.Toolkit.Wpf.UI.Controls.WebView.csproj,low,0
WindowsCommunityToolkit,2455,3,13,added,13,0,Microsoft.Toolkit.Win32/Microsoft.Toolkit.Wpf.UI.Controls.WebView/Properties/AssemblyInfo.cs,high,0
WindowsCommunityToolkit,2455,3,0,renamed,0,0,Microsoft.Toolkit.Win32/Microsoft.Toolkit.Wpf.UI.Controls.WebView/TaskExtensions.cs,high,0
WindowsCommunityToolkit,2455,3,7,added,7,0,Microsoft.Toolkit.Win32/Microsoft.Toolkit.Wpf.UI.Controls.WebView/VisualStudioToolsManifest.xml,medium,0
WindowsCommunityToolkit,2455,3,0,renamed,0,0,Microsoft.Toolkit.Win32/Microsoft.Toolkit.Wpf.UI.Controls.WebView/WebBaseCompatibilityAdapter.cs,high,0
WindowsCommunityToolkit,2455,3,0,renamed,0,0,Microsoft.Toolkit.Win32/Microsoft.Toolkit.Wpf.UI.Controls.WebView/WebBrowserCompatibilityAdapter.cs,high,0
WindowsCommunityToolkit,2455,3,0,renamed,0,0,Microsoft.Toolkit.Win32/Microsoft.Toolkit.Wpf.UI.Controls.WebView/WebView.Dispatch.cs,high,0
WindowsCommunityToolkit,2455,3,1,renamed,1,0,Microsoft.Toolkit.Win32/Microsoft.Toolkit.Wpf.UI.Controls.WebView/WebView.cs,high,0
WindowsCommunityToolkit,2455,3,0,renamed,0,0,Microsoft.Toolkit.Win32/Microsoft.Toolkit.Wpf.UI.Controls.WebView/WebViewCompatibilityAdapter.cs,high,0
WindowsCommunityToolkit,2454,4,7,modified,3,4,Microsoft.Toolkit.Win32/Microsoft.Toolkit.Forms.UI.Controls/Microsoft.Toolkit.Forms.UI.Controls.csproj,low,0
WindowsCommunityToolkit,2454,4,2,modified,1,1,Microsoft.Toolkit.Win32/Microsoft.Toolkit.Sample.Forms.WebView/Form1.Designer.cs,high,0
WindowsCommunityToolkit,2454,4,2,modified,1,1,Microsoft.Toolkit.Win32/Microsoft.Toolkit.Sample.Forms.WebView/Form1.cs,high,0
WindowsCommunityToolkit,2454,4,2,modified,1,1,Microsoft.Toolkit.Win32/Microsoft.Toolkit.Sample.Forms.WebView/Program.cs,high,0
WindowsCommunityToolkit,2454,4,7,modified,3,4,Microsoft.Toolkit.Win32/Microsoft.Toolkit.Wpf.UI.Controls/Microsoft.Toolkit.Wpf.UI.Controls.csproj,low,0
WindowsCommunityToolkit,2454,4,17,modified,0,17,Microsoft.Toolkit.Win32/Microsoft.Toolkit.Wpf.UI.Controls/Properties/AssemblyInfo.cs,high,0
WindowsCommunityToolkit,2454,4,2,modified,1,1,Microsoft.Toolkit.Win32/Microsoft.Toolkit.Wpf.UI.Controls/WebView/Compatible/IWebViewCompatibleAdapter.cs,high,0
WindowsCommunityToolkit,2454,4,10,modified,1,9,Microsoft.Toolkit.Win32/Microsoft.Toolkit.Wpf.UI.Controls/WebView/Compatible/WebBaseCompatibilityAdapter.cs,high,0
WindowsCommunityToolkit,2454,4,31,modified,26,5,Microsoft.Toolkit.Win32/Microsoft.Toolkit.Wpf.UI.Controls/WebView/Compatible/WebBrowserCompatibilityAdapter.cs,high,0
WindowsCommunityToolkit,2454,4,30,modified,25,5,Microsoft.Toolkit.Win32/Microsoft.Toolkit.Wpf.UI.Controls/WebView/Compatible/WebViewCompatibilityAdapter.cs,high,0
WindowsCommunityToolkit,2454,4,10,modified,9,1,Microsoft.Toolkit.Win32/Microsoft.Toolkit.Wpf.UI.Controls/WebView/Compatible/WebViewCompatible.cs,high,0
WindowsCommunityToolkit,2453,25,48,added,48,0,Microsoft.Toolkit.Win32/Microsoft.Toolkit.Forms.UI.Controls.WebView/Microsoft.Toolkit.Forms.UI.Controls.WebView.csproj,low,0
WindowsCommunityToolkit,2453,25,13,added,13,0,Microsoft.Toolkit.Win32/Microsoft.Toolkit.Forms.UI.Controls.WebView/Properties/AssemblyInfo.cs,high,0
WindowsCommunityToolkit,2453,25,2,renamed,1,1,Microsoft.Toolkit.Win32/Microsoft.Toolkit.Forms.UI.Controls.WebView/TaskExtensions.cs,high,0
WindowsCommunityToolkit,2453,25,2,renamed,1,1,Microsoft.Toolkit.Win32/Microsoft.Toolkit.Forms.UI.Controls.WebView/WebView.BaseProperties.cs,high,0
WindowsCommunityToolkit,2453,25,9,renamed,5,4,Microsoft.Toolkit.Win32/Microsoft.Toolkit.Forms.UI.Controls.WebView/WebView.Events.cs,high,0
WindowsCommunityToolkit,2453,25,8,renamed,4,4,Microsoft.Toolkit.Win32/Microsoft.Toolkit.Forms.UI.Controls.WebView/WebView.Init.cs,high,0
WindowsCommunityToolkit,2453,25,3,renamed,2,1,Microsoft.Toolkit.Win32/Microsoft.Toolkit.Forms.UI.Controls.WebView/WebView.Navigation.cs,high,0
WindowsCommunityToolkit,2453,25,9,renamed,4,5,Microsoft.Toolkit.Win32/Microsoft.Toolkit.Forms.UI.Controls.WebView/WebView.cs,high,0
WindowsCommunityToolkit,2453,25,8,renamed,4,4,Microsoft.Toolkit.Win32/Microsoft.Toolkit.Forms.UI.Controls.WebView/WebViewControlHostExtensions.cs,high,0
WindowsCommunityToolkit,2453,25,3,renamed,2,1,Microsoft.Toolkit.Win32/Microsoft.Toolkit.Forms.UI.Controls.WebView/WebViewControlProcessExtensions.cs,high,0
WindowsCommunityToolkit,2453,25,2,renamed,1,1,Microsoft.Toolkit.Win32/Microsoft.Toolkit.Forms.UI.Controls.WebView/WebViewDesigner.cs,high,0
WindowsCommunityToolkit,2453,25,48,added,48,0,Microsoft.Toolkit.Win32/Microsoft.Toolkit.Forms.UI.Controls/Microsoft.Toolkit.Forms.UI.Controls.csproj,low,0
WindowsCommunityToolkit,2453,25,9,added,9,0,Microsoft.Toolkit.Win32/Microsoft.Toolkit.Forms.UI.Controls/Properties/AssemblyInfo.cs,high,0
WindowsCommunityToolkit,2453,25,0,renamed,0,0,Microsoft.Toolkit.Win32/Microsoft.Toolkit.Forms.UI.Controls/Properties/launchSettings.json,medium,0
WindowsCommunityToolkit,2453,25,36,added,36,0,Microsoft.Toolkit.Win32/Microsoft.Toolkit.Forms.UI.Controls/WindowsXamlHostBaseExt.cs,high,0
WindowsCommunityToolkit,2453,25,56,added,56,0,Microsoft.Toolkit.Win32/Microsoft.Toolkit.Forms.UI.Controls/WrapperLookup.cs,high,0
WindowsCommunityToolkit,2453,25,4,modified,2,2,Microsoft.Toolkit.Win32/Microsoft.Toolkit.Forms.UI.XamlHost/Properties/Resources.Designer.cs,high,0
WindowsCommunityToolkit,2453,25,0,renamed,0,0,Microsoft.Toolkit.Win32/Microsoft.Toolkit.Sample.Forms.WebView/App.config,medium,0
WindowsCommunityToolkit,2453,25,39,renamed,19,20,Microsoft.Toolkit.Win32/Microsoft.Toolkit.Sample.Forms.WebView/Form1.Designer.cs,high,0
WindowsCommunityToolkit,2453,25,4,renamed,2,2,Microsoft.Toolkit.Win32/Microsoft.Toolkit.Sample.Forms.WebView/Form1.cs,high,0
WindowsCommunityToolkit,2453,25,0,renamed,0,0,Microsoft.Toolkit.Win32/Microsoft.Toolkit.Sample.Forms.WebView/Form1.resx,medium,0
WindowsCommunityToolkit,2453,25,49,added,49,0,Microsoft.Toolkit.Win32/Microsoft.Toolkit.Sample.Forms.WebView/Microsoft.Toolkit.Sample.Forms.WebView.csproj,low,0
WindowsCommunityToolkit,2453,25,2,renamed,1,1,Microsoft.Toolkit.Win32/Microsoft.Toolkit.Sample.Forms.WebView/Program.cs,high,0
WindowsCommunityToolkit,2453,25,4,renamed,2,2,Microsoft.Toolkit.Win32/Microsoft.Toolkit.Sample.Forms.WebView/Properties/Resources.Designer.cs,high,0
WindowsCommunityToolkit,2453,25,0,renamed,0,0,Microsoft.Toolkit.Win32/Microsoft.Toolkit.Sample.Forms.WebView/Properties/Resources.resx,medium,0
WindowsCommunityToolkit,2453,25,4,renamed,2,2,Microsoft.Toolkit.Win32/Microsoft.Toolkit.Sample.Forms.WebView/Properties/Settings.Designer.cs,high,0
WindowsCommunityToolkit,2453,25,0,renamed,0,0,Microsoft.Toolkit.Win32/Microsoft.Toolkit.Sample.Forms.WebView/Properties/Settings.settings,NaN,0
WindowsCommunityToolkit,2453,25,0,renamed,0,0,Microsoft.Toolkit.Win32/Microsoft.Toolkit.Sample.Forms.WebView/app.manifest,medium,0
WindowsCommunityToolkit,2453,25,9,added,9,0,Microsoft.Toolkit.Win32/Microsoft.Toolkit.Sample.Wpf.App/App.config,medium,0
WindowsCommunityToolkit,2453,25,8,added,8,0,Microsoft.Toolkit.Win32/Microsoft.Toolkit.Sample.Wpf.App/App.xaml,medium,0
WindowsCommunityToolkit,2447,11,51,modified,0,51,Microsoft.Toolkit.Win32/Microsoft.Toolkit.Win32.UI.Controls/Interop/Win32/UnsafeNativeMethods.cs,high,1
WindowsCommunityToolkit,2447,11,19,modified,8,11,Microsoft.Toolkit.Win32/Microsoft.Toolkit.Wpf.UI.Controls.WebView/WebView.cs,high,0
WindowsCommunityToolkit,2447,11,22,modified,14,8,Microsoft.Toolkit.Win32/Microsoft.Toolkit.Wpf.UI.Controls.WebView/WebViewHost.cs,high,0
WindowsCommunityToolkit,2447,11,146,modified,0,146,Microsoft.Toolkit.Win32/WebView.Shared/Interop/Win32/DpiHelper.cs,high,0
WindowsCommunityToolkit,2446,64,7,modified,5,2,Microsoft.Toolkit.Services/Core/IStorageManager.cs,high,0
WindowsCommunityToolkit,2446,64,40,modified,36,4,Microsoft.Toolkit.Services/Microsoft.Toolkit.Services.csproj,low,0
WindowsCommunityToolkit,2446,64,42,added,42,0,Microsoft.Toolkit.Services/PlatformSpecific/NETFramework/NetFrameworkSignatureManager.cs,high,0
WindowsCommunityToolkit,2446,64,159,added,159,0,Microsoft.Toolkit.Services/PlatformSpecific/NETFramework/PasswordManagerNativeMethods.cs,high,0
WindowsCommunityToolkit,2446,64,16,added,16,0,Microsoft.Toolkit.Services/PlatformSpecific/NETFramework/PopupWPF.xaml,medium,0
WindowsCommunityToolkit,2446,64,75,added,75,0,Microsoft.Toolkit.Services/PlatformSpecific/NETFramework/PopupWPF.xaml.cs,high,0
WindowsCommunityToolkit,2446,64,79,added,79,0,Microsoft.Toolkit.Services/PlatformSpecific/NetFramework/NetFrameworkAuthenticationBroker.cs,high,0
WindowsCommunityToolkit,2446,64,79,added,79,0,Microsoft.Toolkit.Services/PlatformSpecific/NetFramework/NetFrameworkPasswordManager.cs,high,0
WindowsCommunityToolkit,2446,64,57,added,57,0,Microsoft.Toolkit.Services/PlatformSpecific/NetFramework/NetFrameworkStorageManager.cs,high,0
WindowsCommunityToolkit,2446,64,65,added,65,0,Microsoft.Toolkit.Services/PlatformSpecific/NetFramework/PopupForm.Designer.cs,high,0
WindowsCommunityToolkit,2446,64,101,added,101,0,Microsoft.Toolkit.Services/PlatformSpecific/NetFramework/PopupForm.cs,high,0
WindowsCommunityToolkit,2446,64,9,modified,6,3,Microsoft.Toolkit.Services/PlatformSpecific/Uwp/UwpStorageManager.cs,high,0
WindowsCommunityToolkit,2446,64,43,modified,35,8,Microsoft.Toolkit.Services/Services/LinkedIn/LinkedInDataProvider.cs,high,0
WindowsCommunityToolkit,2446,64,29,modified,29,0,Microsoft.Toolkit.Services/Services/LinkedIn/LinkedInService.cs,high,0
WindowsCommunityToolkit,2446,64,34,modified,30,4,Microsoft.Toolkit.Services/Services/Twitter/TwitterDataProvider.cs,high,0
WindowsCommunityToolkit,2446,64,30,modified,29,1,Microsoft.Toolkit.Services/Services/Twitter/TwitterService.cs,high,0
WindowsCommunityToolkit,2446,64,54,modified,54,0,Windows Community Toolkit.sln,low,0
WindowsCommunityToolkit,2446,64,2,modified,2,0,docs/services/Linkedin.md,low,0
WindowsCommunityToolkit,2446,64,2,modified,2,0,docs/services/Twitter.md,low,0
WindowsCommunityToolkit,2440,3,2,modified,1,1,Microsoft.Toolkit.Uwp.SampleApp/SamplePages/Expander/ExpanderXaml.bind,medium,0
WindowsCommunityToolkit,2440,3,529,modified,310,219,Microsoft.Toolkit.Uwp.UI.Controls/Expander/Expander.xaml,medium,0
WindowsCommunityToolkit,2440,3,55,modified,38,17,Microsoft.Toolkit.Uwp.UI.Controls/InAppNotification/InAppNotification.xaml,medium,1
WindowsCommunityToolkit,2440,3,90,modified,57,33,Microsoft.Toolkit.Uwp.UI.Controls/Menu/Menu.xaml,medium,0
WindowsCommunityToolkit,2439,18,7,modified,5,2,Microsoft.Toolkit.Services/Core/IStorageManager.cs,high,1
WindowsCommunityToolkit,2439,18,14,modified,14,0,Microsoft.Toolkit.Services/Microsoft.Toolkit.Services.csproj,low,1
WindowsCommunityToolkit,2439,18,218,added,218,0,Microsoft.Toolkit.Services/PlatformSpecific/NETFramework/NetFrameworkPasswordManager.cs,high,1
WindowsCommunityToolkit,2439,18,38,added,38,0,Microsoft.Toolkit.Services/PlatformSpecific/NETFramework/NetFrameworkSignatureManager.cs,high,1
WindowsCommunityToolkit,2439,18,39,added,39,0,Microsoft.Toolkit.Services/PlatformSpecific/NetFramework/NetFrameworkAuthenticationBroker.cs,high,1
WindowsCommunityToolkit,2439,18,38,added,38,0,Microsoft.Toolkit.Services/PlatformSpecific/NetFramework/NetFrameworkSignatureManager.cs,high,1
WindowsCommunityToolkit,2439,18,53,added,53,0,Microsoft.Toolkit.Services/PlatformSpecific/NetFramework/NetFrameworkStorageManager.cs,high,1
WindowsCommunityToolkit,2439,18,61,added,61,0,Microsoft.Toolkit.Services/PlatformSpecific/NetFramework/PopupForm.Designer.cs,high,1
WindowsCommunityToolkit,2439,18,66,added,66,0,Microsoft.Toolkit.Services/PlatformSpecific/NetFramework/PopupForm.cs,high,1
WindowsCommunityToolkit,2439,18,9,modified,6,3,Microsoft.Toolkit.Services/PlatformSpecific/Uwp/UwpStorageManager.cs,high,1
WindowsCommunityToolkit,2439,18,6,modified,3,3,Microsoft.Toolkit.Services/Services/LinkedIn/LinkedInDataProvider.cs,high,1
WindowsCommunityToolkit,2439,18,28,modified,27,1,Microsoft.Toolkit.Services/Services/Twitter/TwitterDataProvider.cs,high,1
WindowsCommunityToolkit,2439,18,28,modified,28,0,Microsoft.Toolkit.Services/Services/Twitter/TwitterService.cs,high,1
WindowsCommunityToolkit,2439,18,6,added,6,0,TwitterServiceTest/App.config,medium,1
WindowsCommunityToolkit,2439,18,74,added,74,0,TwitterServiceTest/Form1.Designer.cs,high,1
WindowsCommunityToolkit,2439,18,37,added,37,0,TwitterServiceTest/Form1.cs,high,1
WindowsCommunityToolkit,2439,18,120,added,120,0,TwitterServiceTest/Form1.resx,medium,1
WindowsCommunityToolkit,2439,18,22,added,22,0,TwitterServiceTest/Program.cs,high,1
WindowsCommunityToolkit,2439,18,36,added,36,0,TwitterServiceTest/Properties/AssemblyInfo.cs,high,1
WindowsCommunityToolkit,2439,18,71,added,71,0,TwitterServiceTest/Properties/Resources.Designer.cs,high,1
WindowsCommunityToolkit,2439,18,117,added,117,0,TwitterServiceTest/Properties/Resources.resx,medium,1
WindowsCommunityToolkit,2439,18,30,added,30,0,TwitterServiceTest/Properties/Settings.Designer.cs,high,1
WindowsCommunityToolkit,2439,18,7,added,7,0,TwitterServiceTest/Properties/Settings.settings,NaN,1
WindowsCommunityToolkit,2439,18,89,added,89,0,TwitterServiceTest/TwitterServiceTest.csproj,low,1
WindowsCommunityToolkit,2439,18,27,modified,27,0,Windows Community Toolkit.sln,low,1
WindowsCommunityToolkit,2439,18,2,modified,2,0,docs/services/Twitter.md,low,1
WindowsCommunityToolkit,2437,221,2,modified,1,1,Microsoft.Toolkit.Win32/Microsoft.Toolkit.Forms.UI.Controls/WindowsXamlHostBaseExt.cs,high,1
WindowsCommunityToolkit,2437,221,13,modified,7,6,Microsoft.Toolkit.Win32/Microsoft.Toolkit.Forms.UI.XamlHost/Interop/Win32/NativeDefines.cs,high,1
WindowsCommunityToolkit,2437,221,51,modified,38,13,Microsoft.Toolkit.Win32/Microsoft.Toolkit.Forms.UI.XamlHost/Interop/Win32/UnsafeNativeMethods.cs,high,1
WindowsCommunityToolkit,2437,221,7,modified,6,1,Microsoft.Toolkit.Win32/Microsoft.Toolkit.Forms.UI.XamlHost/Microsoft.Toolkit.Forms.UI.XamlHost.csproj,low,1
WindowsCommunityToolkit,2437,221,4,modified,2,2,Microsoft.Toolkit.Win32/Microsoft.Toolkit.Forms.UI.XamlHost/Properties/Resources.Designer.cs,high,1
WindowsCommunityToolkit,2437,221,2,modified,1,1,Microsoft.Toolkit.Win32/Microsoft.Toolkit.Forms.UI.XamlHost/WindowsXamlHost.cs,high,1
WindowsCommunityToolkit,2437,221,91,modified,50,41,Microsoft.Toolkit.Win32/Microsoft.Toolkit.Forms.UI.XamlHost/WindowsXamlHostBase.KeyboardFocus.cs,high,1
WindowsCommunityToolkit,2437,221,16,modified,8,8,Microsoft.Toolkit.Win32/Microsoft.Toolkit.Forms.UI.XamlHost/WindowsXamlHostBase.Layout.cs,high,1
WindowsCommunityToolkit,2437,221,2,modified,1,1,Microsoft.Toolkit.Win32/Microsoft.Toolkit.Forms.UI.XamlHost/WindowsXamlHostBase.Window.cs,high,1
WindowsCommunityToolkit,2437,221,2,modified,1,1,Microsoft.Toolkit.Win32/Microsoft.Toolkit.Forms.UI.XamlHost/WindowsXamlHostBase.WndProc.cs,high,1
WindowsCommunityToolkit,2437,221,23,modified,13,10,Microsoft.Toolkit.Win32/Microsoft.Toolkit.Forms.UI.XamlHost/WindowsXamlHostBase.cs,high,1
WindowsCommunityToolkit,2437,221,4,modified,4,0,Microsoft.Toolkit.Win32/Microsoft.Toolkit.Win32.UI.Controls/Interop/Win32/WM.cs,high,1
WindowsCommunityToolkit,2437,221,7,modified,0,7,Microsoft.Toolkit.Win32/Microsoft.Toolkit.Win32.sln,low,1
WindowsCommunityToolkit,2437,221,8,modified,4,4,Microsoft.Toolkit.Win32/Microsoft.Toolkit.Wpf.UI.Controls/InkToolbar/InkToolbar.cs,high,1
WindowsCommunityToolkit,2437,221,2,modified,1,1,Microsoft.Toolkit.Win32/Microsoft.Toolkit.Wpf.UI.Controls/InkToolbar/InkToolbarCustomPenButton.cs,high,1
WindowsCommunityToolkit,2437,221,10,modified,5,5,Microsoft.Toolkit.Win32/Microsoft.Toolkit.Wpf.UI.Controls/WindowsXamlHostWrapperConverter.cs,high,1
WindowsCommunityToolkit,2437,221,7,modified,6,1,Microsoft.Toolkit.Win32/Microsoft.Toolkit.Wpf.UI.XamlHost/Microsoft.Toolkit.Wpf.UI.XamlHost.csproj,low,1
WindowsCommunityToolkit,2437,221,4,modified,2,2,Microsoft.Toolkit.Win32/Microsoft.Toolkit.Wpf.UI.XamlHost/Properties/Resources.Designer.cs,high,1
WindowsCommunityToolkit,2437,221,8,modified,4,4,Microsoft.Toolkit.Win32/Microsoft.Toolkit.Wpf.UI.XamlHost/WindowsXamlHostBase.Focus.cs,high,1
WindowsCommunityToolkit,2437,221,12,modified,6,6,Microsoft.Toolkit.Win32/Microsoft.Toolkit.Wpf.UI.XamlHost/WindowsXamlHostBase.Layout.cs,high,1
WindowsCommunityToolkit,2437,221,34,modified,23,11,Microsoft.Toolkit.Win32/Microsoft.Toolkit.Wpf.UI.XamlHost/WindowsXamlHostBase.cs,high,1
WindowsCommunityToolkit,2437,221,4,modified,0,4,docs/controls/WindowsXAMLHost.md,low,1
WindowsCommunityToolkit,2435,26,33,modified,23,10,Directory.Build.props,medium,1
WindowsCommunityToolkit,2435,26,2,modified,1,1,Directory.Build.targets,low,0
WindowsCommunityToolkit,2435,26,33,added,33,0,Microsoft.Toolkit.Win32/Microsoft.Toolkit.Forms.UI.XamlHost/Interop/Win32/NativeDefines.cs,high,1
WindowsCommunityToolkit,2435,26,41,added,41,0,Microsoft.Toolkit.Win32/Microsoft.Toolkit.Forms.UI.XamlHost/Interop/Win32/SafeNativeMethods.cs,high,0
WindowsCommunityToolkit,2435,26,14,added,14,0,Microsoft.Toolkit.Win32/Microsoft.Toolkit.Forms.UI.XamlHost/Interop/Win32/SetWindowPosFlags.cs,high,0
WindowsCommunityToolkit,2435,26,36,added,36,0,Microsoft.Toolkit.Win32/Microsoft.Toolkit.Forms.UI.XamlHost/Interop/Win32/UnsafeNativeMethods.cs,high,1
WindowsCommunityToolkit,2435,26,74,added,74,0,Microsoft.Toolkit.Win32/Microsoft.Toolkit.Forms.UI.XamlHost/Microsoft.Toolkit.Forms.UI.XamlHost.csproj,low,1
WindowsCommunityToolkit,2435,26,9,added,9,0,Microsoft.Toolkit.Win32/Microsoft.Toolkit.Forms.UI.XamlHost/Properties/AssemblyInfo.cs,high,0
WindowsCommunityToolkit,2435,26,63,added,63,0,Microsoft.Toolkit.Win32/Microsoft.Toolkit.Forms.UI.XamlHost/Properties/Resources.Designer.cs,high,1
WindowsCommunityToolkit,2435,26,117,added,117,0,Microsoft.Toolkit.Win32/Microsoft.Toolkit.Forms.UI.XamlHost/Properties/Resources.resx,medium,0
WindowsCommunityToolkit,2435,26,26,added,26,0,Microsoft.Toolkit.Win32/Microsoft.Toolkit.Forms.UI.XamlHost/Properties/Settings.Designer.cs,high,0
WindowsCommunityToolkit,2435,26,7,added,7,0,Microsoft.Toolkit.Win32/Microsoft.Toolkit.Forms.UI.XamlHost/Properties/Settings.settings,NaN,0
WindowsCommunityToolkit,2435,26,93,added,93,0,Microsoft.Toolkit.Win32/Microsoft.Toolkit.Forms.UI.XamlHost/WindowsXamlHost.cs,high,1
WindowsCommunityToolkit,2435,26,96,added,96,0,Microsoft.Toolkit.Win32/Microsoft.Toolkit.Forms.UI.XamlHost/WindowsXamlHostBase.KeyboardFocus.cs,high,1
WindowsCommunityToolkit,2435,26,135,added,135,0,Microsoft.Toolkit.Win32/Microsoft.Toolkit.Forms.UI.XamlHost/WindowsXamlHostBase.Layout.cs,high,1
WindowsCommunityToolkit,2435,26,29,added,29,0,Microsoft.Toolkit.Win32/Microsoft.Toolkit.Forms.UI.XamlHost/WindowsXamlHostBase.Window.cs,high,1
WindowsCommunityToolkit,2435,26,115,added,115,0,Microsoft.Toolkit.Win32/Microsoft.Toolkit.Forms.UI.XamlHost/WindowsXamlHostBase.WndProc.cs,high,1
WindowsCommunityToolkit,2435,26,194,added,194,0,Microsoft.Toolkit.Win32/Microsoft.Toolkit.Forms.UI.XamlHost/WindowsXamlHostBase.cs,high,1
WindowsCommunityToolkit,2435,26,4,modified,4,0,Microsoft.Toolkit.Win32/Microsoft.Toolkit.Win32.UI.Controls/Interop/Win32/WM.cs,high,1
WindowsCommunityToolkit,2435,26,38,added,38,0,Microsoft.Toolkit.Win32/Microsoft.Toolkit.Win32.UI.XamlHost/DesktopWindowXamlSourceExtensions.cs,high,0
WindowsCommunityToolkit,2435,26,36,added,36,0,Microsoft.Toolkit.Win32/Microsoft.Toolkit.Win32.UI.XamlHost/IDesktopWindowXamlSourceNative.cs,high,0
WindowsCommunityToolkit,2435,26,80,added,80,0,Microsoft.Toolkit.Win32/Microsoft.Toolkit.Win32.UI.XamlHost/MetadataProviderDiscovery.cs,high,0
WindowsCommunityToolkit,2435,26,76,added,76,0,Microsoft.Toolkit.Win32/Microsoft.Toolkit.Win32.UI.XamlHost/UWPTypeFactory.cs,high,0
WindowsCommunityToolkit,2435,26,118,added,118,0,Microsoft.Toolkit.Win32/Microsoft.Toolkit.Win32.UI.XamlHost/XamlApplication.cs,high,0
WindowsCommunityToolkit,2435,26,30,modified,27,3,Microsoft.Toolkit.Win32/Microsoft.Toolkit.Win32.sln,low,1
WindowsCommunityToolkit,2435,26,67,added,67,0,Microsoft.Toolkit.Win32/Microsoft.Toolkit.Wpf.UI.XamlHost/Microsoft.Toolkit.Wpf.UI.XamlHost.csproj,low,1
WindowsCommunityToolkit,2435,26,9,added,9,0,Microsoft.Toolkit.Win32/Microsoft.Toolkit.Wpf.UI.XamlHost/Properties/AssemblyInfo.cs,high,0
WindowsCommunityToolkit,2435,26,63,added,63,0,Microsoft.Toolkit.Win32/Microsoft.Toolkit.Wpf.UI.XamlHost/Properties/Resources.Designer.cs,high,1
WindowsCommunityToolkit,2435,26,117,added,117,0,Microsoft.Toolkit.Win32/Microsoft.Toolkit.Wpf.UI.XamlHost/Properties/Resources.resx,medium,0
WindowsCommunityToolkit,2435,26,26,added,26,0,Microsoft.Toolkit.Win32/Microsoft.Toolkit.Wpf.UI.XamlHost/Properties/Settings.Designer.cs,high,0
WindowsCommunityToolkit,2434,7,14,modified,11,3,Microsoft.Toolkit.Win32/Microsoft.Toolkit.Forms.UI.XamlHost/Interop/Win32/NativeDefines.cs,high,2
WindowsCommunityToolkit,2434,7,24,removed,0,24,Microsoft.Toolkit.Win32/Microsoft.Toolkit.Forms.UI.XamlHost/Interop/Win32/NativeMethods.cs,high,1
WindowsCommunityToolkit,2434,7,22,modified,21,1,Microsoft.Toolkit.Win32/Microsoft.Toolkit.Forms.UI.XamlHost/Interop/Win32/SafeNativeMethods.cs,high,1
WindowsCommunityToolkit,2434,7,2,modified,1,1,Microsoft.Toolkit.Win32/Microsoft.Toolkit.Forms.UI.XamlHost/Interop/Win32/SetWindowPosFlags.cs,high,1
WindowsCommunityToolkit,2434,7,53,modified,50,3,Microsoft.Toolkit.Win32/Microsoft.Toolkit.Forms.UI.XamlHost/Interop/Win32/UnsafeNativeMethods.cs,high,2
WindowsCommunityToolkit,2434,7,28,modified,14,14,Microsoft.Toolkit.Win32/Microsoft.Toolkit.Forms.UI.XamlHost/Properties/AssemblyInfo.cs,high,1
WindowsCommunityToolkit,2434,7,67,modified,18,49,Microsoft.Toolkit.Win32/Microsoft.Toolkit.Forms.UI.XamlHost/WindowsXamlHost.cs,high,2
WindowsCommunityToolkit,2434,7,95,modified,52,43,Microsoft.Toolkit.Win32/Microsoft.Toolkit.Forms.UI.XamlHost/WindowsXamlHostBase.KeyboardFocus.cs,high,2
WindowsCommunityToolkit,2434,7,29,modified,15,14,Microsoft.Toolkit.Win32/Microsoft.Toolkit.Forms.UI.XamlHost/WindowsXamlHostBase.Layout.cs,high,2
WindowsCommunityToolkit,2434,7,113,modified,85,28,Microsoft.Toolkit.Win32/Microsoft.Toolkit.Forms.UI.XamlHost/WindowsXamlHostBase.cs,high,2
WindowsCommunityToolkit,2434,7,4,modified,4,0,Microsoft.Toolkit.Win32/Microsoft.Toolkit.Win32.UI.Controls/Interop/Win32/WM.cs,high,2
WindowsCommunityToolkit,2434,7,10,modified,6,4,Microsoft.Toolkit.Win32/Microsoft.Toolkit.Win32.UI.XamlHost/DesktopWindowXamlSourceExtensions.cs,high,1
WindowsCommunityToolkit,2434,7,16,modified,10,6,Microsoft.Toolkit.Win32/Microsoft.Toolkit.Win32.UI.XamlHost/IDesktopWindowXamlSourceNative.cs,high,1
WindowsCommunityToolkit,2434,7,85,added,85,0,Microsoft.Toolkit.Win32/Microsoft.Toolkit.Win32.UI.XamlHost/MetadataProviderDiscovery.cs,high,1
WindowsCommunityToolkit,2434,7,4,modified,2,2,Microsoft.Toolkit.Win32/Microsoft.Toolkit.Win32.UI.XamlHost/UWPTypeFactory.cs,high,1
WindowsCommunityToolkit,2434,7,114,modified,45,69,Microsoft.Toolkit.Win32/Microsoft.Toolkit.Win32.UI.XamlHost/XamlApplication.cs,high,1
WindowsCommunityToolkit,2434,7,102,modified,102,0,Microsoft.Toolkit.Win32/Microsoft.Toolkit.Win32.sln,low,2
WindowsCommunityToolkit,2434,7,26,modified,13,13,Microsoft.Toolkit.Win32/Microsoft.Toolkit.Wpf.UI.XamlHost/Properties/AssemblyInfo.cs,high,1
WindowsCommunityToolkit,2434,7,71,modified,19,52,Microsoft.Toolkit.Win32/Microsoft.Toolkit.Wpf.UI.XamlHost/WindowsXamlHost.cs,high,1
WindowsCommunityToolkit,2434,7,16,modified,8,8,Microsoft.Toolkit.Win32/Microsoft.Toolkit.Wpf.UI.XamlHost/WindowsXamlHostBase.Focus.cs,high,2
WindowsCommunityToolkit,2434,7,16,modified,8,8,Microsoft.Toolkit.Win32/Microsoft.Toolkit.Wpf.UI.XamlHost/WindowsXamlHostBase.Layout.cs,high,2
WindowsCommunityToolkit,2434,7,110,modified,74,36,Microsoft.Toolkit.Win32/Microsoft.Toolkit.Wpf.UI.XamlHost/WindowsXamlHostBase.cs,high,2
WindowsCommunityToolkit,2433,13,14,modified,11,3,Microsoft.Toolkit.Win32/Microsoft.Toolkit.Forms.UI.XamlHost/Interop/Win32/NativeDefines.cs,high,3
WindowsCommunityToolkit,2433,13,22,modified,21,1,Microsoft.Toolkit.Win32/Microsoft.Toolkit.Forms.UI.XamlHost/Interop/Win32/SafeNativeMethods.cs,high,2
WindowsCommunityToolkit,2433,13,2,modified,1,1,Microsoft.Toolkit.Win32/Microsoft.Toolkit.Forms.UI.XamlHost/Interop/Win32/SetWindowPosFlags.cs,high,2
WindowsCommunityToolkit,2433,13,53,modified,50,3,Microsoft.Toolkit.Win32/Microsoft.Toolkit.Forms.UI.XamlHost/Interop/Win32/UnsafeNativeMethods.cs,high,3
WindowsCommunityToolkit,2433,13,28,modified,14,14,Microsoft.Toolkit.Win32/Microsoft.Toolkit.Forms.UI.XamlHost/Properties/AssemblyInfo.cs,high,2
WindowsCommunityToolkit,2433,13,4,modified,2,2,Microsoft.Toolkit.Win32/Microsoft.Toolkit.Forms.UI.XamlHost/Properties/Resources.Designer.cs,high,2
WindowsCommunityToolkit,2433,13,67,modified,18,49,Microsoft.Toolkit.Win32/Microsoft.Toolkit.Forms.UI.XamlHost/WindowsXamlHost.cs,high,3
WindowsCommunityToolkit,2433,13,95,modified,52,43,Microsoft.Toolkit.Win32/Microsoft.Toolkit.Forms.UI.XamlHost/WindowsXamlHostBase.KeyboardFocus.cs,high,3
WindowsCommunityToolkit,2433,13,29,modified,15,14,Microsoft.Toolkit.Win32/Microsoft.Toolkit.Forms.UI.XamlHost/WindowsXamlHostBase.Layout.cs,high,3
WindowsCommunityToolkit,2433,13,113,modified,85,28,Microsoft.Toolkit.Win32/Microsoft.Toolkit.Forms.UI.XamlHost/WindowsXamlHostBase.cs,high,3
WindowsCommunityToolkit,2433,13,4,modified,4,0,Microsoft.Toolkit.Win32/Microsoft.Toolkit.Win32.UI.Controls/Interop/Win32/WM.cs,high,3
WindowsCommunityToolkit,2433,13,10,modified,6,4,Microsoft.Toolkit.Win32/Microsoft.Toolkit.Win32.UI.XamlHost/DesktopWindowXamlSourceExtensions.cs,high,2
WindowsCommunityToolkit,2433,13,16,modified,10,6,Microsoft.Toolkit.Win32/Microsoft.Toolkit.Win32.UI.XamlHost/IDesktopWindowXamlSourceNative.cs,high,2
WindowsCommunityToolkit,2433,13,85,added,85,0,Microsoft.Toolkit.Win32/Microsoft.Toolkit.Win32.UI.XamlHost/MetadataProviderDiscovery.cs,high,2
WindowsCommunityToolkit,2433,13,4,modified,2,2,Microsoft.Toolkit.Win32/Microsoft.Toolkit.Win32.UI.XamlHost/UWPTypeFactory.cs,high,2
WindowsCommunityToolkit,2433,13,114,modified,45,69,Microsoft.Toolkit.Win32/Microsoft.Toolkit.Win32.UI.XamlHost/XamlApplication.cs,high,2
WindowsCommunityToolkit,2433,13,102,modified,102,0,Microsoft.Toolkit.Win32/Microsoft.Toolkit.Win32.sln,low,3
WindowsCommunityToolkit,2433,13,26,modified,13,13,Microsoft.Toolkit.Win32/Microsoft.Toolkit.Wpf.UI.XamlHost/Properties/AssemblyInfo.cs,high,2
WindowsCommunityToolkit,2433,13,4,modified,2,2,Microsoft.Toolkit.Win32/Microsoft.Toolkit.Wpf.UI.XamlHost/Properties/Resources.Designer.cs,high,2
WindowsCommunityToolkit,2433,13,71,modified,19,52,Microsoft.Toolkit.Win32/Microsoft.Toolkit.Wpf.UI.XamlHost/WindowsXamlHost.cs,high,2
WindowsCommunityToolkit,2433,13,16,modified,8,8,Microsoft.Toolkit.Win32/Microsoft.Toolkit.Wpf.UI.XamlHost/WindowsXamlHostBase.Focus.cs,high,3
WindowsCommunityToolkit,2433,13,16,modified,8,8,Microsoft.Toolkit.Win32/Microsoft.Toolkit.Wpf.UI.XamlHost/WindowsXamlHostBase.Layout.cs,high,3
WindowsCommunityToolkit,2433,13,110,modified,74,36,Microsoft.Toolkit.Win32/Microsoft.Toolkit.Wpf.UI.XamlHost/WindowsXamlHostBase.cs,high,3
WindowsCommunityToolkit,2432,222,64,added,64,0,Microsoft.Toolkit.Win32/Microsoft.Toolkit.Forms.UI.Controls/Microsoft.Toolkit.Forms.UI.Controls.csproj,low,0
WindowsCommunityToolkit,2432,222,9,added,9,0,Microsoft.Toolkit.Win32/Microsoft.Toolkit.Forms.UI.Controls/Properties/AssemblyInfo.cs,high,0
WindowsCommunityToolkit,2432,222,0,renamed,0,0,Microsoft.Toolkit.Win32/Microsoft.Toolkit.Forms.UI.Controls/Properties/launchSettings.json,medium,0
WindowsCommunityToolkit,2432,222,2,renamed,1,1,Microsoft.Toolkit.Win32/Microsoft.Toolkit.Forms.UI.Controls/TaskExtensions.cs,high,0
WindowsCommunityToolkit,2432,222,2,renamed,1,1,Microsoft.Toolkit.Win32/Microsoft.Toolkit.Forms.UI.Controls/WebView/WebView.BaseProperties.cs,high,0
WindowsCommunityToolkit,2432,222,9,renamed,5,4,Microsoft.Toolkit.Win32/Microsoft.Toolkit.Forms.UI.Controls/WebView/WebView.Events.cs,high,0
WindowsCommunityToolkit,2432,222,8,renamed,4,4,Microsoft.Toolkit.Win32/Microsoft.Toolkit.Forms.UI.Controls/WebView/WebView.Init.cs,high,0
WindowsCommunityToolkit,2432,222,3,renamed,2,1,Microsoft.Toolkit.Win32/Microsoft.Toolkit.Forms.UI.Controls/WebView/WebView.Navigation.cs,high,0
WindowsCommunityToolkit,2432,222,9,renamed,4,5,Microsoft.Toolkit.Win32/Microsoft.Toolkit.Forms.UI.Controls/WebView/WebView.cs,high,0
WindowsCommunityToolkit,2432,222,8,renamed,4,4,Microsoft.Toolkit.Win32/Microsoft.Toolkit.Forms.UI.Controls/WebView/WebViewControlHostExtensions.cs,high,0
WindowsCommunityToolkit,2432,222,3,renamed,2,1,Microsoft.Toolkit.Win32/Microsoft.Toolkit.Forms.UI.Controls/WebView/WebViewControlProcessExtensions.cs,high,0
WindowsCommunityToolkit,2432,222,2,renamed,1,1,Microsoft.Toolkit.Win32/Microsoft.Toolkit.Forms.UI.Controls/WebView/WebViewDesigner.cs,high,0
WindowsCommunityToolkit,2432,222,36,added,36,0,Microsoft.Toolkit.Win32/Microsoft.Toolkit.Forms.UI.Controls/WindowsXamlHostBaseExt.cs,high,1
WindowsCommunityToolkit,2432,222,50,added,50,0,Microsoft.Toolkit.Win32/Microsoft.Toolkit.Forms.UI.Controls/WrapperLookup.cs,high,0
WindowsCommunityToolkit,2432,222,4,modified,2,2,Microsoft.Toolkit.Win32/Microsoft.Toolkit.Forms.UI.XamlHost/Properties/Resources.Designer.cs,high,2
WindowsCommunityToolkit,2432,222,0,renamed,0,0,Microsoft.Toolkit.Win32/Microsoft.Toolkit.Sample.Forms.WebView/App.config,medium,0
WindowsCommunityToolkit,2432,222,56,renamed,17,39,Microsoft.Toolkit.Win32/Microsoft.Toolkit.Sample.Forms.WebView/Form1.Designer.cs,high,0
WindowsCommunityToolkit,2432,222,4,renamed,2,2,Microsoft.Toolkit.Win32/Microsoft.Toolkit.Sample.Forms.WebView/Form1.cs,high,0
WindowsCommunityToolkit,2432,222,0,renamed,0,0,Microsoft.Toolkit.Win32/Microsoft.Toolkit.Sample.Forms.WebView/Form1.resx,medium,0
WindowsCommunityToolkit,2432,222,10,renamed,5,5,Microsoft.Toolkit.Win32/Microsoft.Toolkit.Sample.Forms.WebView/Microsoft.Toolkit.Sample.Forms.WebView.csproj,low,0
WindowsCommunityToolkit,2432,222,2,renamed,1,1,Microsoft.Toolkit.Win32/Microsoft.Toolkit.Sample.Forms.WebView/Program.cs,high,0
WindowsCommunityToolkit,2432,222,4,renamed,2,2,Microsoft.Toolkit.Win32/Microsoft.Toolkit.Sample.Forms.WebView/Properties/AssemblyInfo.cs,high,0
WindowsCommunityToolkit,2432,222,4,renamed,2,2,Microsoft.Toolkit.Win32/Microsoft.Toolkit.Sample.Forms.WebView/Properties/Resources.Designer.cs,high,0
WindowsCommunityToolkit,2432,222,0,renamed,0,0,Microsoft.Toolkit.Win32/Microsoft.Toolkit.Sample.Forms.WebView/Properties/Resources.resx,medium,0
WindowsCommunityToolkit,2432,222,4,renamed,2,2,Microsoft.Toolkit.Win32/Microsoft.Toolkit.Sample.Forms.WebView/Properties/Settings.Designer.cs,high,0
WindowsCommunityToolkit,2432,222,0,renamed,0,0,Microsoft.Toolkit.Win32/Microsoft.Toolkit.Sample.Forms.WebView/Properties/Settings.settings,NaN,0
WindowsCommunityToolkit,2432,222,0,renamed,0,0,Microsoft.Toolkit.Win32/Microsoft.Toolkit.Sample.Forms.WebView/app.manifest,medium,0
WindowsCommunityToolkit,2432,222,9,added,9,0,Microsoft.Toolkit.Win32/Microsoft.Toolkit.Sample.Wpf.App/App.config,medium,0
WindowsCommunityToolkit,2432,222,8,added,8,0,Microsoft.Toolkit.Win32/Microsoft.Toolkit.Sample.Wpf.App/App.xaml,medium,0
WindowsCommunityToolkit,2432,222,21,added,21,0,Microsoft.Toolkit.Win32/Microsoft.Toolkit.Sample.Wpf.App/App.xaml.cs,high,0
WindowsCommunityToolkit,2431,192,57,renamed,18,39,Microsoft.Toolkit.Win32/Microsoft.Toolkit.Forms.UI.Controls/Microsoft.Toolkit.Forms.UI.Controls.csproj,low,0
WindowsCommunityToolkit,2431,192,52,added,52,0,Microsoft.Toolkit.Win32/Microsoft.Toolkit.Forms.UI.Controls/Properties/AssemblyInfo.cs,high,0
WindowsCommunityToolkit,2431,192,0,renamed,0,0,Microsoft.Toolkit.Win32/Microsoft.Toolkit.Forms.UI.Controls/Properties/launchSettings.json,medium,0
WindowsCommunityToolkit,2431,192,2,renamed,1,1,Microsoft.Toolkit.Win32/Microsoft.Toolkit.Forms.UI.Controls/TaskExtensions.cs,high,0
WindowsCommunityToolkit,2431,192,2,renamed,1,1,Microsoft.Toolkit.Win32/Microsoft.Toolkit.Forms.UI.Controls/WebView/WebView.BaseProperties.cs,high,0
WindowsCommunityToolkit,2431,192,9,renamed,5,4,Microsoft.Toolkit.Win32/Microsoft.Toolkit.Forms.UI.Controls/WebView/WebView.Events.cs,high,0
WindowsCommunityToolkit,2431,192,8,renamed,4,4,Microsoft.Toolkit.Win32/Microsoft.Toolkit.Forms.UI.Controls/WebView/WebView.Init.cs,high,0
WindowsCommunityToolkit,2431,192,3,renamed,2,1,Microsoft.Toolkit.Win32/Microsoft.Toolkit.Forms.UI.Controls/WebView/WebView.Navigation.cs,high,0
WindowsCommunityToolkit,2431,192,9,renamed,4,5,Microsoft.Toolkit.Win32/Microsoft.Toolkit.Forms.UI.Controls/WebView/WebView.cs,high,0
WindowsCommunityToolkit,2431,192,8,renamed,4,4,Microsoft.Toolkit.Win32/Microsoft.Toolkit.Forms.UI.Controls/WebView/WebViewControlHostExtensions.cs,high,0
WindowsCommunityToolkit,2431,192,3,renamed,2,1,Microsoft.Toolkit.Win32/Microsoft.Toolkit.Forms.UI.Controls/WebView/WebViewControlProcessExtensions.cs,high,0
WindowsCommunityToolkit,2431,192,2,renamed,1,1,Microsoft.Toolkit.Win32/Microsoft.Toolkit.Forms.UI.Controls/WebView/WebViewDesigner.cs,high,0
WindowsCommunityToolkit,2431,192,36,added,36,0,Microsoft.Toolkit.Win32/Microsoft.Toolkit.Forms.UI.Controls/WindowsXamlHostBaseExt.cs,high,1
WindowsCommunityToolkit,2431,192,50,added,50,0,Microsoft.Toolkit.Win32/Microsoft.Toolkit.Forms.UI.Controls/WrapperLookup.cs,high,0
WindowsCommunityToolkit,2431,192,9,modified,8,1,Microsoft.Toolkit.Win32/Microsoft.Toolkit.Forms.UI.XamlHost/Interop/Win32/NativeDefines.cs,high,3
WindowsCommunityToolkit,2431,192,24,removed,0,24,Microsoft.Toolkit.Win32/Microsoft.Toolkit.Forms.UI.XamlHost/Interop/Win32/NativeMethods.cs,high,1
WindowsCommunityToolkit,2431,192,22,modified,21,1,Microsoft.Toolkit.Win32/Microsoft.Toolkit.Forms.UI.XamlHost/Interop/Win32/SafeNativeMethods.cs,high,2
WindowsCommunityToolkit,2431,192,2,modified,1,1,Microsoft.Toolkit.Win32/Microsoft.Toolkit.Forms.UI.XamlHost/Interop/Win32/SetWindowPosFlags.cs,high,2
WindowsCommunityToolkit,2431,192,13,modified,12,1,Microsoft.Toolkit.Win32/Microsoft.Toolkit.Forms.UI.XamlHost/Interop/Win32/UnsafeNativeMethods.cs,high,3
WindowsCommunityToolkit,2431,192,28,modified,14,14,Microsoft.Toolkit.Win32/Microsoft.Toolkit.Forms.UI.XamlHost/Properties/AssemblyInfo.cs,high,2
WindowsCommunityToolkit,2431,192,67,modified,18,49,Microsoft.Toolkit.Win32/Microsoft.Toolkit.Forms.UI.XamlHost/WindowsXamlHost.cs,high,3
WindowsCommunityToolkit,2431,192,56,modified,28,28,Microsoft.Toolkit.Win32/Microsoft.Toolkit.Forms.UI.XamlHost/WindowsXamlHostBase.KeyboardFocus.cs,high,3
WindowsCommunityToolkit,2431,192,29,modified,15,14,Microsoft.Toolkit.Win32/Microsoft.Toolkit.Forms.UI.XamlHost/WindowsXamlHostBase.Layout.cs,high,3
WindowsCommunityToolkit,2431,192,110,modified,82,28,Microsoft.Toolkit.Win32/Microsoft.Toolkit.Forms.UI.XamlHost/WindowsXamlHostBase.cs,high,3
WindowsCommunityToolkit,2431,192,0,renamed,0,0,Microsoft.Toolkit.Win32/Microsoft.Toolkit.Sample.Forms.WebView/App.config,medium,0
WindowsCommunityToolkit,2431,192,56,renamed,17,39,Microsoft.Toolkit.Win32/Microsoft.Toolkit.Sample.Forms.WebView/Form1.Designer.cs,high,0
WindowsCommunityToolkit,2431,192,4,renamed,2,2,Microsoft.Toolkit.Win32/Microsoft.Toolkit.Sample.Forms.WebView/Form1.cs,high,0
WindowsCommunityToolkit,2431,192,0,renamed,0,0,Microsoft.Toolkit.Win32/Microsoft.Toolkit.Sample.Forms.WebView/Form1.resx,medium,0
WindowsCommunityToolkit,2431,192,10,renamed,5,5,Microsoft.Toolkit.Win32/Microsoft.Toolkit.Sample.Forms.WebView/Microsoft.Toolkit.Sample.Forms.WebView.csproj,low,0
WindowsCommunityToolkit,2431,192,2,renamed,1,1,Microsoft.Toolkit.Win32/Microsoft.Toolkit.Sample.Forms.WebView/Program.cs,high,0
WindowsCommunityToolkit,2430,1,33,modified,10,23,Directory.Build.props,medium,1
WindowsCommunityToolkit,2430,1,2,modified,1,1,Directory.Build.targets,low,0
WindowsCommunityToolkit,2430,1,25,removed,0,25,Microsoft.Toolkit.Win32/Microsoft.Toolkit.Forms.UI.XamlHost/Interop/Win32/NativeDefines.cs,high,3
WindowsCommunityToolkit,2430,1,24,removed,0,24,Microsoft.Toolkit.Win32/Microsoft.Toolkit.Forms.UI.XamlHost/Interop/Win32/NativeMethods.cs,high,1
WindowsCommunityToolkit,2430,1,26,removed,0,26,Microsoft.Toolkit.Win32/Microsoft.Toolkit.Forms.UI.XamlHost/Interop/Win32/SafeNativeMethods.cs,high,2
WindowsCommunityToolkit,2430,1,14,removed,0,14,Microsoft.Toolkit.Win32/Microsoft.Toolkit.Forms.UI.XamlHost/Interop/Win32/SetWindowPosFlags.cs,high,2
WindowsCommunityToolkit,2430,1,43,removed,0,43,Microsoft.Toolkit.Win32/Microsoft.Toolkit.Forms.UI.XamlHost/Interop/Win32/UnsafeNativeMethods.cs,high,3
WindowsCommunityToolkit,2430,1,75,removed,0,75,Microsoft.Toolkit.Win32/Microsoft.Toolkit.Forms.UI.XamlHost/Microsoft.Toolkit.Forms.UI.XamlHost.csproj,low,1
WindowsCommunityToolkit,2430,1,26,removed,0,26,Microsoft.Toolkit.Win32/Microsoft.Toolkit.Forms.UI.XamlHost/Properties/AssemblyInfo.cs,high,2
WindowsCommunityToolkit,2430,1,63,removed,0,63,Microsoft.Toolkit.Win32/Microsoft.Toolkit.Forms.UI.XamlHost/Properties/Resources.Designer.cs,high,2
WindowsCommunityToolkit,2430,1,117,removed,0,117,Microsoft.Toolkit.Win32/Microsoft.Toolkit.Forms.UI.XamlHost/Properties/Resources.resx,medium,0
WindowsCommunityToolkit,2430,1,26,removed,0,26,Microsoft.Toolkit.Win32/Microsoft.Toolkit.Forms.UI.XamlHost/Properties/Settings.Designer.cs,high,0
WindowsCommunityToolkit,2430,1,7,removed,0,7,Microsoft.Toolkit.Win32/Microsoft.Toolkit.Forms.UI.XamlHost/Properties/Settings.settings,NaN,0
WindowsCommunityToolkit,2430,1,124,removed,0,124,Microsoft.Toolkit.Win32/Microsoft.Toolkit.Forms.UI.XamlHost/WindowsXamlHost.cs,high,3
WindowsCommunityToolkit,2430,1,105,removed,0,105,Microsoft.Toolkit.Win32/Microsoft.Toolkit.Forms.UI.XamlHost/WindowsXamlHostBase.KeyboardFocus.cs,high,3
WindowsCommunityToolkit,2430,1,134,removed,0,134,Microsoft.Toolkit.Win32/Microsoft.Toolkit.Forms.UI.XamlHost/WindowsXamlHostBase.Layout.cs,high,3
WindowsCommunityToolkit,2430,1,29,removed,0,29,Microsoft.Toolkit.Win32/Microsoft.Toolkit.Forms.UI.XamlHost/WindowsXamlHostBase.Window.cs,high,1
WindowsCommunityToolkit,2430,1,123,removed,0,123,Microsoft.Toolkit.Win32/Microsoft.Toolkit.Forms.UI.XamlHost/WindowsXamlHostBase.WndProc.cs,high,1
WindowsCommunityToolkit,2430,1,125,removed,0,125,Microsoft.Toolkit.Win32/Microsoft.Toolkit.Forms.UI.XamlHost/WindowsXamlHostBase.cs,high,3
WindowsCommunityToolkit,2430,1,36,removed,0,36,Microsoft.Toolkit.Win32/Microsoft.Toolkit.Win32.UI.XamlHost/DesktopWindowXamlSourceExtensions.cs,high,2
WindowsCommunityToolkit,2430,1,32,removed,0,32,Microsoft.Toolkit.Win32/Microsoft.Toolkit.Win32.UI.XamlHost/IDesktopWindowXamlSourceNative.cs,high,2
WindowsCommunityToolkit,2430,1,74,removed,0,74,Microsoft.Toolkit.Win32/Microsoft.Toolkit.Win32.UI.XamlHost/UWPTypeFactory.cs,high,2
WindowsCommunityToolkit,2430,1,143,removed,0,143,Microsoft.Toolkit.Win32/Microsoft.Toolkit.Win32.UI.XamlHost/XamlApplication.cs,high,2
WindowsCommunityToolkit,2430,1,30,modified,3,27,Microsoft.Toolkit.Win32/Microsoft.Toolkit.Win32.sln,low,3
WindowsCommunityToolkit,2430,1,68,removed,0,68,Microsoft.Toolkit.Win32/Microsoft.Toolkit.Wpf.UI.XamlHost/Microsoft.Toolkit.Wpf.UI.XamlHost.csproj,low,1
WindowsCommunityToolkit,2430,1,26,removed,0,26,Microsoft.Toolkit.Win32/Microsoft.Toolkit.Wpf.UI.XamlHost/Properties/AssemblyInfo.cs,high,2
WindowsCommunityToolkit,2430,1,63,removed,0,63,Microsoft.Toolkit.Win32/Microsoft.Toolkit.Wpf.UI.XamlHost/Properties/Resources.Designer.cs,high,2
WindowsCommunityToolkit,2430,1,117,removed,0,117,Microsoft.Toolkit.Win32/Microsoft.Toolkit.Wpf.UI.XamlHost/Properties/Resources.resx,medium,0
WindowsCommunityToolkit,2430,1,26,removed,0,26,Microsoft.Toolkit.Win32/Microsoft.Toolkit.Wpf.UI.XamlHost/Properties/Settings.Designer.cs,high,0
WindowsCommunityToolkit,2430,1,7,removed,0,7,Microsoft.Toolkit.Win32/Microsoft.Toolkit.Wpf.UI.XamlHost/Properties/Settings.settings,NaN,0
WindowsCommunityToolkit,2426,5,22,modified,20,2,Microsoft.Toolkit.Win32/Microsoft.Toolkit.Win32.UI.Controls/Interop/WinRT/WebViewControlProcess.cs,high,0
WindowsCommunityToolkit,2425,9,28,modified,16,12,Microsoft.Toolkit.Uwp.UI.Controls/Menu/Menu.Logic.cs,high,0
WindowsCommunityToolkit,2425,9,1,modified,0,1,Microsoft.Toolkit.Uwp.UI.Controls/Menu/Menu.cs,high,0
WindowsCommunityToolkit,2425,9,5,modified,5,0,Microsoft.Toolkit.Uwp.UI.Controls/Menu/MenuItem.cs,high,0
WindowsCommunityToolkit,2424,1,33,modified,23,10,Directory.Build.props,medium,1
WindowsCommunityToolkit,2424,1,2,modified,1,1,Directory.Build.targets,low,0
WindowsCommunityToolkit,2424,1,25,added,25,0,Microsoft.Toolkit.Win32/Microsoft.Toolkit.Forms.UI.XamlHost/Interop/Win32/NativeDefines.cs,high,3
WindowsCommunityToolkit,2424,1,24,added,24,0,Microsoft.Toolkit.Win32/Microsoft.Toolkit.Forms.UI.XamlHost/Interop/Win32/NativeMethods.cs,high,1
WindowsCommunityToolkit,2424,1,26,added,26,0,Microsoft.Toolkit.Win32/Microsoft.Toolkit.Forms.UI.XamlHost/Interop/Win32/SafeNativeMethods.cs,high,2
WindowsCommunityToolkit,2424,1,14,added,14,0,Microsoft.Toolkit.Win32/Microsoft.Toolkit.Forms.UI.XamlHost/Interop/Win32/SetWindowPosFlags.cs,high,2
WindowsCommunityToolkit,2424,1,43,added,43,0,Microsoft.Toolkit.Win32/Microsoft.Toolkit.Forms.UI.XamlHost/Interop/Win32/UnsafeNativeMethods.cs,high,3
WindowsCommunityToolkit,2424,1,75,added,75,0,Microsoft.Toolkit.Win32/Microsoft.Toolkit.Forms.UI.XamlHost/Microsoft.Toolkit.Forms.UI.XamlHost.csproj,low,1
WindowsCommunityToolkit,2424,1,26,added,26,0,Microsoft.Toolkit.Win32/Microsoft.Toolkit.Forms.UI.XamlHost/Properties/AssemblyInfo.cs,high,2
WindowsCommunityToolkit,2424,1,63,added,63,0,Microsoft.Toolkit.Win32/Microsoft.Toolkit.Forms.UI.XamlHost/Properties/Resources.Designer.cs,high,2
WindowsCommunityToolkit,2424,1,117,added,117,0,Microsoft.Toolkit.Win32/Microsoft.Toolkit.Forms.UI.XamlHost/Properties/Resources.resx,medium,0
WindowsCommunityToolkit,2424,1,26,added,26,0,Microsoft.Toolkit.Win32/Microsoft.Toolkit.Forms.UI.XamlHost/Properties/Settings.Designer.cs,high,0
WindowsCommunityToolkit,2424,1,7,added,7,0,Microsoft.Toolkit.Win32/Microsoft.Toolkit.Forms.UI.XamlHost/Properties/Settings.settings,NaN,0
WindowsCommunityToolkit,2424,1,124,added,124,0,Microsoft.Toolkit.Win32/Microsoft.Toolkit.Forms.UI.XamlHost/WindowsXamlHost.cs,high,3
WindowsCommunityToolkit,2424,1,105,added,105,0,Microsoft.Toolkit.Win32/Microsoft.Toolkit.Forms.UI.XamlHost/WindowsXamlHostBase.KeyboardFocus.cs,high,3
WindowsCommunityToolkit,2424,1,134,added,134,0,Microsoft.Toolkit.Win32/Microsoft.Toolkit.Forms.UI.XamlHost/WindowsXamlHostBase.Layout.cs,high,3
WindowsCommunityToolkit,2424,1,29,added,29,0,Microsoft.Toolkit.Win32/Microsoft.Toolkit.Forms.UI.XamlHost/WindowsXamlHostBase.Window.cs,high,1
WindowsCommunityToolkit,2424,1,123,added,123,0,Microsoft.Toolkit.Win32/Microsoft.Toolkit.Forms.UI.XamlHost/WindowsXamlHostBase.WndProc.cs,high,1
WindowsCommunityToolkit,2424,1,125,added,125,0,Microsoft.Toolkit.Win32/Microsoft.Toolkit.Forms.UI.XamlHost/WindowsXamlHostBase.cs,high,3
WindowsCommunityToolkit,2424,1,36,added,36,0,Microsoft.Toolkit.Win32/Microsoft.Toolkit.Win32.UI.XamlHost/DesktopWindowXamlSourceExtensions.cs,high,2
WindowsCommunityToolkit,2424,1,32,added,32,0,Microsoft.Toolkit.Win32/Microsoft.Toolkit.Win32.UI.XamlHost/IDesktopWindowXamlSourceNative.cs,high,2
WindowsCommunityToolkit,2424,1,74,added,74,0,Microsoft.Toolkit.Win32/Microsoft.Toolkit.Win32.UI.XamlHost/UWPTypeFactory.cs,high,2
WindowsCommunityToolkit,2424,1,143,added,143,0,Microsoft.Toolkit.Win32/Microsoft.Toolkit.Win32.UI.XamlHost/XamlApplication.cs,high,2
WindowsCommunityToolkit,2424,1,30,modified,27,3,Microsoft.Toolkit.Win32/Microsoft.Toolkit.Win32.sln,low,3
WindowsCommunityToolkit,2424,1,68,added,68,0,Microsoft.Toolkit.Win32/Microsoft.Toolkit.Wpf.UI.XamlHost/Microsoft.Toolkit.Wpf.UI.XamlHost.csproj,low,1
WindowsCommunityToolkit,2424,1,26,added,26,0,Microsoft.Toolkit.Win32/Microsoft.Toolkit.Wpf.UI.XamlHost/Properties/AssemblyInfo.cs,high,2
WindowsCommunityToolkit,2424,1,63,added,63,0,Microsoft.Toolkit.Win32/Microsoft.Toolkit.Wpf.UI.XamlHost/Properties/Resources.Designer.cs,high,2
WindowsCommunityToolkit,2424,1,117,added,117,0,Microsoft.Toolkit.Win32/Microsoft.Toolkit.Wpf.UI.XamlHost/Properties/Resources.resx,medium,0
WindowsCommunityToolkit,2424,1,26,added,26,0,Microsoft.Toolkit.Win32/Microsoft.Toolkit.Wpf.UI.XamlHost/Properties/Settings.Designer.cs,high,0
WindowsCommunityToolkit,2424,1,7,added,7,0,Microsoft.Toolkit.Win32/Microsoft.Toolkit.Wpf.UI.XamlHost/Properties/Settings.settings,NaN,0
WindowsCommunityToolkit,2423,2,2,modified,1,1,Microsoft.Toolkit.Uwp.SampleApp/SamplePages/samples.json,medium,0
WindowsCommunityToolkit,2422,5,2,modified,1,1,Directory.Build.props,medium,2
WindowsCommunityToolkit,2422,5,2,modified,1,1,version.json,medium,2
WindowsCommunityToolkit,2420,2,20,modified,11,9,Directory.Build.props,medium,2
WindowsCommunityToolkit,2420,2,2,modified,1,1,Directory.Build.targets,low,0
WindowsCommunityToolkit,2420,2,14,renamed,7,7,Microsoft.Toolkit.Win32/Microsoft.Toolkit.Forms.UI.Controls/Microsoft.Toolkit.Forms.UI.Controls.csproj,low,0
WindowsCommunityToolkit,2420,2,0,renamed,0,0,Microsoft.Toolkit.Win32/Microsoft.Toolkit.Forms.UI.Controls/Properties/AssemblyInfo.cs,high,0
WindowsCommunityToolkit,2420,2,0,renamed,0,0,Microsoft.Toolkit.Win32/Microsoft.Toolkit.Forms.UI.Controls/Properties/launchSettings.json,medium,0
WindowsCommunityToolkit,2420,2,0,renamed,0,0,Microsoft.Toolkit.Win32/Microsoft.Toolkit.Forms.UI.Controls/TaskExtensions.cs,high,0
WindowsCommunityToolkit,2420,2,2,renamed,1,1,Microsoft.Toolkit.Win32/Microsoft.Toolkit.Forms.UI.Controls/WebView/WebView.BaseProperties.cs,high,0
WindowsCommunityToolkit,2420,2,5,renamed,3,2,Microsoft.Toolkit.Win32/Microsoft.Toolkit.Forms.UI.Controls/WebView/WebView.Events.cs,high,0
WindowsCommunityToolkit,2420,2,8,renamed,4,4,Microsoft.Toolkit.Win32/Microsoft.Toolkit.Forms.UI.Controls/WebView/WebView.Init.cs,high,0
WindowsCommunityToolkit,2420,2,3,renamed,2,1,Microsoft.Toolkit.Win32/Microsoft.Toolkit.Forms.UI.Controls/WebView/WebView.Navigation.cs,high,0
WindowsCommunityToolkit,2420,2,9,renamed,4,5,Microsoft.Toolkit.Win32/Microsoft.Toolkit.Forms.UI.Controls/WebView/WebView.cs,high,0
WindowsCommunityToolkit,2420,2,2,renamed,1,1,Microsoft.Toolkit.Win32/Microsoft.Toolkit.Forms.UI.Controls/WebView/WebViewControlHostExtensions.cs,high,0
WindowsCommunityToolkit,2420,2,3,renamed,2,1,Microsoft.Toolkit.Win32/Microsoft.Toolkit.Forms.UI.Controls/WebView/WebViewControlProcessExtensions.cs,high,0
WindowsCommunityToolkit,2420,2,2,renamed,1,1,Microsoft.Toolkit.Win32/Microsoft.Toolkit.Forms.UI.Controls/WebView/WebViewDesigner.cs,high,0
WindowsCommunityToolkit,2420,2,6,renamed,3,3,Microsoft.Toolkit.Win32/Microsoft.Toolkit.Forms.UI.Controls/WindowsXamlHostBaseExt.cs,high,1
WindowsCommunityToolkit,2420,2,3,renamed,1,2,Microsoft.Toolkit.Win32/Microsoft.Toolkit.Forms.UI.Controls/WrapperLookup.cs,high,0
WindowsCommunityToolkit,2420,2,2,renamed,1,1,Microsoft.Toolkit.Win32/Microsoft.Toolkit.Forms.UI.XamlHost/Interop/Win32/NativeDefines.cs,high,3
WindowsCommunityToolkit,2420,2,2,renamed,1,1,Microsoft.Toolkit.Win32/Microsoft.Toolkit.Forms.UI.XamlHost/Interop/Win32/SafeNativeMethods.cs,high,2
WindowsCommunityToolkit,2420,2,2,renamed,1,1,Microsoft.Toolkit.Win32/Microsoft.Toolkit.Forms.UI.XamlHost/Interop/Win32/SetWindowPosFlags.cs,high,2
WindowsCommunityToolkit,2420,2,2,renamed,1,1,Microsoft.Toolkit.Win32/Microsoft.Toolkit.Forms.UI.XamlHost/Interop/Win32/UnsafeNativeMethods.cs,high,3
WindowsCommunityToolkit,2420,2,16,renamed,7,9,Microsoft.Toolkit.Win32/Microsoft.Toolkit.Forms.UI.XamlHost/Microsoft.Toolkit.Forms.UI.XamlHost.csproj,low,1
WindowsCommunityToolkit,2420,2,4,renamed,2,2,Microsoft.Toolkit.Win32/Microsoft.Toolkit.Forms.UI.XamlHost/Properties/AssemblyInfo.cs,high,2
WindowsCommunityToolkit,2420,2,0,renamed,0,0,Microsoft.Toolkit.Win32/Microsoft.Toolkit.Forms.UI.XamlHost/Properties/Resources.Designer.cs,high,2
WindowsCommunityToolkit,2420,2,0,renamed,0,0,Microsoft.Toolkit.Win32/Microsoft.Toolkit.Forms.UI.XamlHost/Properties/Resources.resx,medium,0
WindowsCommunityToolkit,2420,2,0,renamed,0,0,Microsoft.Toolkit.Win32/Microsoft.Toolkit.Forms.UI.XamlHost/Properties/Settings.Designer.cs,high,0
WindowsCommunityToolkit,2420,2,0,renamed,0,0,Microsoft.Toolkit.Win32/Microsoft.Toolkit.Forms.UI.XamlHost/Properties/Settings.settings,NaN,0
WindowsCommunityToolkit,2420,2,3,renamed,2,1,Microsoft.Toolkit.Win32/Microsoft.Toolkit.Forms.UI.XamlHost/WindowsXamlHost.cs,high,3
WindowsCommunityToolkit,2420,2,4,renamed,2,2,Microsoft.Toolkit.Win32/Microsoft.Toolkit.Forms.UI.XamlHost/WindowsXamlHostBase.KeyboardFocus.cs,high,3
WindowsCommunityToolkit,2420,2,2,renamed,1,1,Microsoft.Toolkit.Win32/Microsoft.Toolkit.Forms.UI.XamlHost/WindowsXamlHostBase.Layout.cs,high,3
WindowsCommunityToolkit,2420,2,5,renamed,2,3,Microsoft.Toolkit.Win32/Microsoft.Toolkit.Forms.UI.XamlHost/WindowsXamlHostBase.Window.cs,high,1
WindowsCommunityToolkit,2417,8,9,modified,2,7,Microsoft.Toolkit.Services/Microsoft.Toolkit.Services.csproj,low,1
WindowsCommunityToolkit,2417,8,83,added,83,0,Microsoft.Toolkit.Services/Services/MicrosoftGraph/AuthenticationHelperV2.cs,high,0
WindowsCommunityToolkit,2417,8,45,added,45,0,Microsoft.Toolkit.Services/Services/MicrosoftGraph/IAuthenticationHelper.cs,high,0
WindowsCommunityToolkit,2417,8,227,modified,31,196,Microsoft.Toolkit.Services/Services/MicrosoftGraph/MicrosoftGraphAuthenticationHelper.cs,high,0
WindowsCommunityToolkit,2417,8,142,modified,116,26,Microsoft.Toolkit.Services/Services/MicrosoftGraph/MicrosoftGraphService.cs,high,0
WindowsCommunityToolkit,2417,8,69,added,69,0,Microsoft.Toolkit.Services/Services/MicrosoftGraph/Platform/Uwp/AuthenticationHelperV1.cs,high,0
WindowsCommunityToolkit,2417,8,10,modified,0,10,Microsoft.Toolkit.Services/Services/OneDrive/OneDriveService.cs,high,0
WindowsCommunityToolkit,2417,8,8,modified,8,0,Microsoft.Toolkit.Uwp.SampleApp/Controls/AadAuthControl.xaml,medium,0
WindowsCommunityToolkit,2417,8,19,modified,16,3,Microsoft.Toolkit.Uwp.SampleApp/Controls/AadAuthControl.xaml.cs,high,0
WindowsCommunityToolkit,2417,8,5,modified,4,1,Microsoft.Toolkit.Uwp.SampleApp/SamplePages/OneDrive Service/OneDrivePage.xaml.cs,high,0
WindowsCommunityToolkit,2417,8,4,modified,0,4,Microsoft.Toolkit.Uwp.UI.Controls.Graph/Microsoft.Toolkit.Uwp.UI.Controls.Graph.csproj,low,0
WindowsCommunityToolkit,2417,8,2,modified,1,1,Microsoft.Toolkit.Uwp.UI.Controls.Graph/PowerBIEmbedded/PowerBIEmbedded.Events.cs,high,0
WindowsCommunityToolkit,2417,8,14,modified,5,9,Microsoft.Toolkit.Uwp.UI.Controls.Graph/PowerBIEmbedded/PowerBIEmbedded.cs,high,0
WindowsCommunityToolkit,2415,1,2,modified,1,1,Microsoft.Toolkit.Win32/Microsoft.Toolkit.Win32.UI.Controls/Microsoft.Toolkit.Win32.UI.Controls.csproj,low,2
WindowsCommunityToolkit,2415,1,2,modified,1,1,build/vsts-build.yml,medium,1
WindowsCommunityToolkit,2414,1,3,modified,1,2,Microsoft.Toolkit.Services/Microsoft.Toolkit.Services.csproj,low,2
WindowsCommunityToolkit,2414,1,7,added,7,0,Microsoft.Toolkit.Services/VisualStudioToolsManifest.xml,medium,1
WindowsCommunityToolkit,2410,5,4,modified,3,1,Microsoft.Toolkit.Uwp.UI.Controls/AdaptiveGridView/AdaptiveGridView.cs,high,0
WindowsCommunityToolkit,2409,4,2,modified,1,1,Microsoft.Toolkit.Uwp.SampleApp/SamplePages/Twitter Service/TwitterPage.xaml,medium,0
WindowsCommunityToolkit,2408,13,3,modified,2,1,Microsoft.Toolkit.Uwp.UI.Controls/BladeView/BladeView.Properties.cs,high,0
WindowsCommunityToolkit,2408,13,60,modified,34,26,Microsoft.Toolkit.Uwp.UI.Controls/BladeView/BladeView.cs,high,0
WindowsCommunityToolkit,2401,16,8,modified,8,0,Microsoft.Toolkit.Uwp.SampleApp/Microsoft.Toolkit.Uwp.SampleApp.csproj,low,0
WindowsCommunityToolkit,2401,16,35,added,35,0,Microsoft.Toolkit.Uwp.SampleApp/SamplePages/ViewportBehavior/ViewportBehaviorCode.bind,medium,0
WindowsCommunityToolkit,2401,16,67,added,67,0,Microsoft.Toolkit.Uwp.SampleApp/SamplePages/ViewportBehavior/ViewportBehaviorPage.xaml,medium,0
WindowsCommunityToolkit,2401,16,71,added,71,0,Microsoft.Toolkit.Uwp.SampleApp/SamplePages/ViewportBehavior/ViewportBehaviorPage.xaml.cs,high,0
WindowsCommunityToolkit,2401,16,6,modified,6,0,Microsoft.Toolkit.Uwp.SampleApp/SamplePages/samples.json,medium,0
WindowsCommunityToolkit,2401,16,174,added,174,0,Microsoft.Toolkit.Uwp.UI.Animations/Behaviors/ViewportBehavior.cs,high,0
WindowsCommunityToolkit,2400,9,11,modified,7,4,Microsoft.Toolkit.Services/Microsoft.Toolkit.Services.csproj,low,2
WindowsCommunityToolkit,2400,9,54,modified,54,0,Microsoft.Toolkit.Services/Services/Twitter/Tweet.cs,high,0
WindowsCommunityToolkit,2400,9,7,modified,7,0,Microsoft.Toolkit.Services/Services/Twitter/TwitterEntities.cs,high,0
WindowsCommunityToolkit,2400,9,26,added,26,0,Microsoft.Toolkit.Services/Services/Twitter/TwitterSymbol.cs,high,0
WindowsCommunityToolkit,2400,9,11,modified,5,6,Microsoft.Toolkit.Services/Services/Twitter/TwitterUser.cs,high,0
WindowsCommunityToolkit,2400,9,2,modified,1,1,Microsoft.Toolkit.Uwp.SampleApp/Microsoft.Toolkit.Uwp.SampleApp.csproj,low,0
WindowsCommunityToolkit,2400,9,1,modified,0,1,Microsoft.Toolkit.Uwp.SampleApp/SamplePages/Twitter Service/TwitterPage.xaml.cs,high,0
WindowsCommunityToolkit,2400,9,4,modified,0,4,UnitTests/UnitTests.csproj,low,0
WindowsCommunityToolkit,2400,9,48,modified,26,22,Windows Community Toolkit.sln,low,1
WindowsCommunityToolkit,2397,18,14,modified,13,1,Microsoft.Toolkit.Uwp.UI.Controls/Expander/Expander.Properties.cs,high,0
WindowsCommunityToolkit,2397,18,39,modified,39,0,Microsoft.Toolkit.Uwp.UI.Controls/Expander/Expander.cs,high,0
WindowsCommunityToolkit,2397,18,18,modified,18,0,Microsoft.Toolkit.Uwp.UI.Controls/Expander/Expander.xaml,medium,0
WindowsCommunityToolkit,2395,5,4,modified,2,2,Microsoft.Toolkit.Parsers/Markdown/Inlines/CommentInline.cs,high,0
WindowsCommunityToolkit,2394,1,2,modified,1,1,Microsoft.Toolkit.Uwp.UI.Controls/GridSplitter/GridSplitter.xaml,medium,0
WindowsCommunityToolkit,2385,8,7,modified,7,0,Microsoft.Toolkit.Win32/Microsoft.Toolkit.Win32.UI.Controls/IWebView.cs,high,1
WindowsCommunityToolkit,2385,8,6,modified,3,3,Microsoft.Toolkit.Win32/Microsoft.Toolkit.Win32.UI.Controls/Interop/WinRT/WebViewControlHost.cs,high,1
WindowsCommunityToolkit,2385,8,4,modified,2,2,Microsoft.Toolkit.Win32/Microsoft.Toolkit.Win32.UI.Controls/Microsoft.Toolkit.Win32.UI.Controls.csproj,low,2
WindowsCommunityToolkit,2385,8,8,modified,6,2,Microsoft.Toolkit.Win32/Microsoft.Toolkit.Win32.UI.Controls/WPF/WebView/WebView.cs,high,1
WindowsCommunityToolkit,2385,8,8,modified,6,2,Microsoft.Toolkit.Win32/Microsoft.Toolkit.Win32.UI.Controls/WinForms/WebView/WebView.cs,high,1
WindowsCommunityToolkit,2385,8,12,modified,5,7,Microsoft.Toolkit.Win32/Tests/UnitTests.WebView.WinForms/FunctionalTests/PreLoad/PreLoadTests.cs,high,1
WindowsCommunityToolkit,2385,8,4,modified,2,2,build/vsts-build.yml,medium,1
WindowsCommunityToolkit,2384,4,7,modified,5,2,Microsoft.Toolkit.Win32/Microsoft.Toolkit.Win32.UI.Controls/WPF/DispatcherExtensions.cs,high,0
WindowsCommunityToolkit,2384,4,120,added,120,0,Microsoft.Toolkit.Win32/Microsoft.Toolkit.Win32.UI.Controls/WPF/WebView/WebView.Dispatch.cs,high,0
WindowsCommunityToolkit,2384,4,179,modified,96,83,Microsoft.Toolkit.Win32/Microsoft.Toolkit.Win32.UI.Controls/WPF/WebView/WebView.cs,high,1
WindowsCommunityToolkit,2384,4,2,modified,1,1,Microsoft.Toolkit.Win32/Tests/UnitTests.WebView.WinForms/FunctionalTests/PreLoad/PreLoadTests.cs,high,1
WindowsCommunityToolkit,2382,25,14,modified,14,0,Microsoft.Toolkit.Uwp.UI.Controls/ImageEx/ImageExBase.Source.cs,high,0
WindowsCommunityToolkit,2381,4,7,modified,7,0,Microsoft.Toolkit.Win32/Microsoft.Toolkit.Win32.UI.Controls/WPF/WebView/WebView.cs,high,1
WindowsCommunityToolkit,2381,4,32,modified,22,10,Microsoft.Toolkit.Win32/Microsoft.Toolkit.Win32.UI.Controls/WinForms/WebView/WebView.Init.cs,high,0
WindowsCommunityToolkit,2381,4,6,modified,6,0,Microsoft.Toolkit.Win32/Microsoft.Toolkit.Win32.UI.Controls/WinForms/WebView/WebView.cs,high,1
WindowsCommunityToolkit,2381,4,248,added,248,0,Microsoft.Toolkit.Win32/Tests/UnitTests.WebView.WinForms/FunctionalTests/Cookies/CookieTests.cs,high,0
WindowsCommunityToolkit,2381,4,12,modified,3,9,docs/controls/WebView-known-issues.md,low,0
WindowsCommunityToolkit,2381,4,82,modified,82,0,docs/controls/WebView.md,low,0
WindowsCommunityToolkit,2376,1,77,added,77,0,Microsoft.Toolkit.Win32/Tests/UnitTests.WebView.WinForms/FunctionalTests/Navigation/NavigateWithHttpMessageTests.cs,high,0
WindowsCommunityToolkit,2376,1,39,modified,39,0,Microsoft.Toolkit.Win32/Tests/UnitTests.WebView.WinForms/FunctionalTests/WebViewFormContextSpecification.cs,high,0
WindowsCommunityToolkit,2371,1,9,modified,0,9,Microsoft.Toolkit.Win32/Microsoft.Toolkit.Win32.UI.Controls/Interop/WinRT/WebViewControlHost.cs,high,1
WindowsCommunityToolkit,2371,1,30,added,30,0,Microsoft.Toolkit.Win32/Microsoft.Toolkit.Win32.UI.Controls/WPF/TaskExtensions.cs,high,0
WindowsCommunityToolkit,2371,1,33,modified,6,27,Microsoft.Toolkit.Win32/Microsoft.Toolkit.Win32.UI.Controls/WPF/WebView/WebView.cs,high,1
WindowsCommunityToolkit,2371,1,24,added,24,0,Microsoft.Toolkit.Win32/Microsoft.Toolkit.Win32.UI.Controls/WinForms/TaskExtensions.cs,high,0
WindowsCommunityToolkit,2371,1,11,modified,8,3,Microsoft.Toolkit.Win32/Microsoft.Toolkit.Win32.UI.Controls/WinForms/WebView/WebView.cs,high,1
WindowsCommunityToolkit,2371,1,31,modified,31,0,Microsoft.Toolkit.Win32/Tests/UnitTests.WebView.WinForms/FunctionalTests/InvokeScript/InvokeScriptTests.cs,high,0
WindowsCommunityToolkit,2370,1,9,modified,0,9,Microsoft.Toolkit.Win32.UI.Controls/Interop/WinRT/WebViewControlHost.cs,high,0
WindowsCommunityToolkit,2370,1,30,added,30,0,Microsoft.Toolkit.Win32.UI.Controls/WPF/TaskExtensions.WPF.cs,high,0
WindowsCommunityToolkit,2370,1,33,modified,6,27,Microsoft.Toolkit.Win32.UI.Controls/WPF/WebView/WebView.cs,high,0
WindowsCommunityToolkit,2370,1,24,added,24,0,Microsoft.Toolkit.Win32.UI.Controls/WinForms/TaskExtensions.WinForms.cs,high,0
WindowsCommunityToolkit,2370,1,11,modified,8,3,Microsoft.Toolkit.Win32.UI.Controls/WinForms/WebView/WebView.cs,high,0
WindowsCommunityToolkit,2369,5,5,modified,3,2,Microsoft.Toolkit.Uwp.SampleApp/SamplePages/samples.json,medium,0
WindowsCommunityToolkit,2369,5,2,modified,2,0,Microsoft.Toolkit.Uwp.UI/Extensions/NavigationView/NavigationViewExtensions.cs,high,0
WindowsCommunityToolkit,2369,5,3,modified,3,0,docs/extensions/NavigationView.md,low,0
WindowsCommunityToolkit,2368,19,164,added,164,0,Microsoft.Toolkit.Parsers/Markdown/Blocks/YamlHeaderBlock.cs,high,0
WindowsCommunityToolkit,2368,19,5,modified,5,0,Microsoft.Toolkit.Parsers/Markdown/Enums/InlineParseMethod.cs,high,0
WindowsCommunityToolkit,2368,19,7,modified,6,1,Microsoft.Toolkit.Parsers/Markdown/Enums/MarkdownBlockType.cs,high,0
WindowsCommunityToolkit,2368,19,5,modified,5,0,Microsoft.Toolkit.Parsers/Markdown/Enums/MarkdownInlineType.cs,high,0
WindowsCommunityToolkit,2368,19,5,modified,5,0,Microsoft.Toolkit.Parsers/Markdown/Helpers/Common.cs,high,0
WindowsCommunityToolkit,2368,19,5,modified,2,3,Microsoft.Toolkit.Parsers/Markdown/Inlines/CommentInline.cs,high,0
WindowsCommunityToolkit,2368,19,95,added,95,0,Microsoft.Toolkit.Parsers/Markdown/Inlines/SubscriptTextInline.cs,high,0
WindowsCommunityToolkit,2368,19,88,modified,68,20,Microsoft.Toolkit.Parsers/Markdown/Inlines/SuperscriptTextInline.cs,high,0
WindowsCommunityToolkit,2368,19,16,modified,15,1,Microsoft.Toolkit.Parsers/Markdown/MarkdownDocument.cs,high,0
WindowsCommunityToolkit,2368,19,5,modified,5,0,Microsoft.Toolkit.Parsers/Markdown/Render/MarkdownRendererBase.Blocks.cs,high,0
WindowsCommunityToolkit,2368,19,7,modified,7,0,Microsoft.Toolkit.Parsers/Markdown/Render/MarkdownRendererBase.Inlines.cs,high,0
WindowsCommunityToolkit,2368,19,1,modified,1,0,Microsoft.Toolkit.Uwp.SampleApp/readme.md,low,0
WindowsCommunityToolkit,2368,19,57,modified,56,1,Microsoft.Toolkit.Uwp.UI.Controls/MarkdownTextBlock/MarkdownTextBlock.Dimensions.cs,high,0
WindowsCommunityToolkit,2368,19,4,modified,4,0,Microsoft.Toolkit.Uwp.UI.Controls/MarkdownTextBlock/MarkdownTextBlock.Methods.cs,high,0
WindowsCommunityToolkit,2368,19,40,modified,39,1,Microsoft.Toolkit.Uwp.UI.Controls/MarkdownTextBlock/MarkdownTextBlock.Properties.cs,high,0
WindowsCommunityToolkit,2368,19,7,modified,7,0,Microsoft.Toolkit.Uwp.UI.Controls/MarkdownTextBlock/MarkdownTextBlock.xaml,medium,0
WindowsCommunityToolkit,2368,19,59,modified,58,1,Microsoft.Toolkit.Uwp.UI.Controls/MarkdownTextBlock/Render/MarkdownRenderer.Blocks.cs,high,0
WindowsCommunityToolkit,2368,19,15,modified,15,0,Microsoft.Toolkit.Uwp.UI.Controls/MarkdownTextBlock/Render/MarkdownRenderer.Dimensions.cs,high,0
WindowsCommunityToolkit,2368,19,55,modified,51,4,Microsoft.Toolkit.Uwp.UI.Controls/MarkdownTextBlock/Render/MarkdownRenderer.Inlines.cs,high,0
WindowsCommunityToolkit,2368,19,11,modified,11,0,Microsoft.Toolkit.Uwp.UI.Controls/MarkdownTextBlock/Render/MarkdownRenderer.Properties.cs,high,0
WindowsCommunityToolkit,2368,19,2,modified,2,0,UnitTests/Markdown/Parse/ParseTestExtensionMethods.cs,high,0
WindowsCommunityToolkit,2368,19,37,added,37,0,UnitTests/Markdown/Parse/SubscriptTests.cs,high,0
WindowsCommunityToolkit,2368,19,13,modified,13,0,UnitTests/Markdown/Parse/SuperscriptTests.cs,high,0
WindowsCommunityToolkit,2368,19,1,modified,1,0,UnitTests/UnitTests.csproj,low,0
WindowsCommunityToolkit,2366,3,151,added,151,0,Microsoft.Toolkit.Parsers/Markdown/Blocks/YamlHeaderBlock.cs,high,1
WindowsCommunityToolkit,2366,3,5,modified,5,0,Microsoft.Toolkit.Parsers/Markdown/Enums/InlineParseMethod.cs,high,1
WindowsCommunityToolkit,2366,3,7,modified,6,1,Microsoft.Toolkit.Parsers/Markdown/Enums/MarkdownBlockType.cs,high,1
WindowsCommunityToolkit,2366,3,5,modified,5,0,Microsoft.Toolkit.Parsers/Markdown/Enums/MarkdownInlineType.cs,high,1
WindowsCommunityToolkit,2366,3,5,modified,5,0,Microsoft.Toolkit.Parsers/Markdown/Helpers/Common.cs,high,1
WindowsCommunityToolkit,2366,3,86,added,86,0,Microsoft.Toolkit.Parsers/Markdown/Inlines/SubscriptTextInline.cs,high,1
WindowsCommunityToolkit,2366,3,72,modified,52,20,Microsoft.Toolkit.Parsers/Markdown/Inlines/SuperscriptTextInline.cs,high,1
WindowsCommunityToolkit,2366,3,16,modified,15,1,Microsoft.Toolkit.Parsers/Markdown/MarkdownDocument.cs,high,1
WindowsCommunityToolkit,2366,3,5,modified,5,0,Microsoft.Toolkit.Parsers/Markdown/Render/MarkdownRendererBase.Blocks.cs,high,1
WindowsCommunityToolkit,2366,3,7,modified,7,0,Microsoft.Toolkit.Parsers/Markdown/Render/MarkdownRendererBase.Inlines.cs,high,1
WindowsCommunityToolkit,2363,2,20,modified,20,0,Microsoft.Toolkit.Win32/Microsoft.Toolkit.Win32.UI.Controls/WinForms/WebView/WebView.cs,high,1
WindowsCommunityToolkit,2362,1,20,modified,20,0,Microsoft.Toolkit.Win32.UI.Controls/WinForms/WebView/WebView.cs,high,0
WindowsCommunityToolkit,2361,3,9,modified,6,3,Directory.Build.props,medium,2
WindowsCommunityToolkit,2361,3,9,modified,0,9,Directory.Build.targets,low,0
WindowsCommunityToolkit,2361,3,2,modified,1,1,GazeInputTest/GazeInputTest.csproj,low,0
WindowsCommunityToolkit,2361,3,1,modified,1,0,Microsoft.Toolkit.Services/Microsoft.Toolkit.Services.csproj,low,2
WindowsCommunityToolkit,2361,3,2,modified,1,1,Microsoft.Toolkit.Uwp.Notifications/Microsoft.Toolkit.Uwp.Notifications.csproj,low,0
WindowsCommunityToolkit,2361,3,2,modified,1,1,Microsoft.Toolkit.Uwp.SampleApp/Microsoft.Toolkit.Uwp.SampleApp.csproj,low,0
WindowsCommunityToolkit,2361,3,2,modified,1,1,Microsoft.Toolkit.Uwp.Samples.BackgroundTasks/Microsoft.Toolkit.Uwp.Samples.BackgroundTasks.csproj,low,0
WindowsCommunityToolkit,2361,3,4,modified,0,4,Microsoft.Toolkit.Uwp.UI.Animations/Microsoft.Toolkit.Uwp.UI.Animations.csproj,low,0
WindowsCommunityToolkit,2361,3,4,modified,0,4,Microsoft.Toolkit.Uwp.UI.Controls/Microsoft.Toolkit.Uwp.UI.Controls.csproj,low,0
WindowsCommunityToolkit,2361,3,2,modified,1,1,UnitTests/UnitTests.Notifications.UWP/UnitTests.Notifications.UWP.csproj,low,0
WindowsCommunityToolkit,2361,3,2,modified,1,1,UnitTests/UnitTests.Notifications.WinRT/UnitTests.Notifications.WinRT.csproj,low,0
WindowsCommunityToolkit,2361,3,2,modified,1,1,UnitTests/UnitTests.csproj,low,0
WindowsCommunityToolkit,2359,1,36,modified,18,18,Microsoft.Toolkit.Win32.UI.Controls/WPF/WebView/WebView.cs,high,0
WindowsCommunityToolkit,2358,4,36,modified,18,18,Microsoft.Toolkit.Win32/Microsoft.Toolkit.Win32.UI.Controls/WPF/WebView/WebView.cs,high,1
WindowsCommunityToolkit,2357,169,20,modified,15,5,Directory.Build.props,medium,3
WindowsCommunityToolkit,2357,169,9,added,9,0,Microsoft.Toolkit.Win32/Microsoft.Toolkit.Win32.Samples.WPF.App/App.config,medium,1
WindowsCommunityToolkit,2357,169,8,added,8,0,Microsoft.Toolkit.Win32/Microsoft.Toolkit.Win32.Samples.WPF.App/App.xaml,medium,1
WindowsCommunityToolkit,2357,169,21,added,21,0,Microsoft.Toolkit.Win32/Microsoft.Toolkit.Win32.Samples.WPF.App/App.xaml.cs,high,1
WindowsCommunityToolkit,2357,169,0,added,0,0,Microsoft.Toolkit.Win32/Microsoft.Toolkit.Win32.Samples.WPF.App/Assets/storelogo-sdk.png,low,1
WindowsCommunityToolkit,2357,169,56,added,56,0,Microsoft.Toolkit.Win32/Microsoft.Toolkit.Win32.Samples.WPF.App/MainWindow.xaml,medium,1
WindowsCommunityToolkit,2357,169,93,added,93,0,Microsoft.Toolkit.Win32/Microsoft.Toolkit.Win32.Samples.WPF.App/MainWindow.xaml.cs,high,1
WindowsCommunityToolkit,2357,169,120,added,120,0,Microsoft.Toolkit.Win32/Microsoft.Toolkit.Win32.Samples.WPF.App/Microsoft.Toolkit.Win32.Samples.WPF.App.csproj,low,1
WindowsCommunityToolkit,2357,169,46,added,46,0,Microsoft.Toolkit.Win32/Microsoft.Toolkit.Win32.Samples.WPF.App/Properties/AssemblyInfo.cs,high,1
WindowsCommunityToolkit,2357,169,63,added,63,0,Microsoft.Toolkit.Win32/Microsoft.Toolkit.Win32.Samples.WPF.App/Properties/Resources.Designer.cs,high,1
WindowsCommunityToolkit,2357,169,117,added,117,0,Microsoft.Toolkit.Win32/Microsoft.Toolkit.Win32.Samples.WPF.App/Properties/Resources.resx,medium,1
WindowsCommunityToolkit,2357,169,26,added,26,0,Microsoft.Toolkit.Win32/Microsoft.Toolkit.Win32.Samples.WPF.App/Properties/Settings.Designer.cs,high,1
WindowsCommunityToolkit,2357,169,7,added,7,0,Microsoft.Toolkit.Win32/Microsoft.Toolkit.Win32.Samples.WPF.App/Properties/Settings.settings,NaN,1
WindowsCommunityToolkit,2357,169,75,added,75,0,Microsoft.Toolkit.Win32/Microsoft.Toolkit.Win32.Samples.WPF.App/app.manifest,medium,1
WindowsCommunityToolkit,2357,169,3,modified,2,1,Microsoft.Toolkit.Win32/Microsoft.Toolkit.Win32.Samples.WPF.WebView/MainWindow.xaml,medium,1
WindowsCommunityToolkit,2357,169,2,modified,1,1,Microsoft.Toolkit.Win32/Microsoft.Toolkit.Win32.Samples.WPF.WebView/MainWindow.xaml.cs,high,1
WindowsCommunityToolkit,2357,169,6,modified,3,3,Microsoft.Toolkit.Win32/Microsoft.Toolkit.Win32.Samples.WPF.WebView/Microsoft.Toolkit.Win32.Samples.WPF.WebView.csproj,low,1
WindowsCommunityToolkit,2357,169,2,modified,1,1,Microsoft.Toolkit.Win32/Microsoft.Toolkit.Win32.Samples.WPF.WebView/Properties/Settings.Designer.cs,high,1
WindowsCommunityToolkit,2357,169,9,added,9,0,Microsoft.Toolkit.Win32/Microsoft.Toolkit.Win32.Samples.WinForms.App/App.config,medium,1
WindowsCommunityToolkit,2357,169,200,added,200,0,Microsoft.Toolkit.Win32/Microsoft.Toolkit.Win32.Samples.WinForms.App/Form1.Designer.cs,high,1
WindowsCommunityToolkit,2357,169,35,added,35,0,Microsoft.Toolkit.Win32/Microsoft.Toolkit.Win32.Samples.WinForms.App/Form1.cs,high,1
WindowsCommunityToolkit,2357,169,120,added,120,0,Microsoft.Toolkit.Win32/Microsoft.Toolkit.Win32.Samples.WinForms.App/Form1.resx,medium,1
WindowsCommunityToolkit,2357,169,105,added,105,0,Microsoft.Toolkit.Win32/Microsoft.Toolkit.Win32.Samples.WinForms.App/Microsoft.Toolkit.Win32.Samples.WinForms.App.csproj,low,1
WindowsCommunityToolkit,2357,169,26,added,26,0,Microsoft.Toolkit.Win32/Microsoft.Toolkit.Win32.Samples.WinForms.App/Program.cs,high,1
WindowsCommunityToolkit,2357,169,29,added,29,0,Microsoft.Toolkit.Win32/Microsoft.Toolkit.Win32.Samples.WinForms.App/Properties/AssemblyInfo.cs,high,1
WindowsCommunityToolkit,2357,169,71,added,71,0,Microsoft.Toolkit.Win32/Microsoft.Toolkit.Win32.Samples.WinForms.App/Properties/Resources.Designer.cs,high,1
WindowsCommunityToolkit,2357,169,117,added,117,0,Microsoft.Toolkit.Win32/Microsoft.Toolkit.Win32.Samples.WinForms.App/Properties/Resources.resx,medium,1
WindowsCommunityToolkit,2357,169,30,added,30,0,Microsoft.Toolkit.Win32/Microsoft.Toolkit.Win32.Samples.WinForms.App/Properties/Settings.Designer.cs,high,1
WindowsCommunityToolkit,2357,169,7,added,7,0,Microsoft.Toolkit.Win32/Microsoft.Toolkit.Win32.Samples.WinForms.App/Properties/Settings.settings,NaN,1
WindowsCommunityToolkit,2357,169,76,added,76,0,Microsoft.Toolkit.Win32/Microsoft.Toolkit.Win32.Samples.WinForms.App/app.manifest,medium,1
WindowsCommunityToolkit,2354,2,4,modified,3,1,Microsoft.Toolkit.Uwp.UI.Controls.DataGrid/Properties/AssemblyInfo.cs,high,0
WindowsCommunityToolkit,2354,2,4,modified,3,1,Microsoft.Toolkit.Uwp.UI.Controls.Graph/Properties/AssemblyInfo.cs,high,0
WindowsCommunityToolkit,2354,2,4,modified,3,1,Microsoft.Toolkit.Uwp.UI.Controls/Properties/AssemblyInfo.cs,high,0
WindowsCommunityToolkit,2352,2,4,modified,2,2,docs/services/MicrosoftTranslator.md,low,0
WindowsCommunityToolkit,2349,2,46,modified,45,1,Microsoft.Toolkit.Win32/Microsoft.Toolkit.Win32.UI.Controls/WPF/WebView/WebView.cs,high,1
WindowsCommunityToolkit,2348,12,22,modified,22,0,Microsoft.Toolkit.Uwp.UI/Media/RadialGradientBrush.cs,high,0
WinObjC,2873,3,2070,modified,1035,1035,Frameworks/CoreFoundation/Base.subproj/CFInternal.h,high,0
WinObjC,2873,3,1456,modified,728,728,Frameworks/CoreFoundation/Collections.subproj/CFDictionary.c,high,0
WinObjC,2873,3,1354,modified,677,677,Frameworks/CoreFoundation/String.subproj/CFAttributedString.c,high,0
WinObjC,2873,3,160,modified,80,80,Frameworks/OpenGLES/GLES1122/OpenGLESUtil.mm,medium,0
WinObjC,2873,3,334,modified,167,167,Frameworks/UIKit/UIViewControllerContextTransitioning.mm,medium,0
WinObjC,2873,3,200,modified,100,100,build/Headers/Headers.Shared/Public.Shared.vcxitems,NaN,0
WinObjC,2873,3,532,modified,266,266,build/Tests/UnitTests/UIKit/UIKit.UnitTests.vcxproj,medium,0
WinObjC,2873,3,0,modified,0,0,deps/3rdparty/cassowary-0.60/java/cda/classes/Above.gif,NaN,0
WinObjC,2873,3,0,modified,0,0,deps/3rdparty/cassowary-0.60/java/cda/classes/Anchor.gif,NaN,0
WinObjC,2873,3,0,modified,0,0,deps/3rdparty/cassowary-0.60/java/cda/classes/Below.gif,NaN,0
WinObjC,2873,3,0,modified,0,0,deps/3rdparty/cassowary-0.60/java/cda/classes/Blank.gif,NaN,0
WinObjC,2873,3,0,modified,0,0,deps/3rdparty/cassowary-0.60/java/cda/classes/BottomAlign.gif,NaN,0
WinObjC,2873,3,0,modified,0,0,deps/3rdparty/cassowary-0.60/java/cda/classes/CircleCC.gif,NaN,0
WinObjC,2873,3,0,modified,0,0,deps/3rdparty/cassowary-0.60/java/cda/classes/Colocation.gif,NaN,0
WinObjC,2873,3,0,modified,0,0,deps/3rdparty/cassowary-0.60/java/cda/classes/LeftAlign.gif,NaN,0
WinObjC,2873,3,0,modified,0,0,deps/3rdparty/cassowary-0.60/java/cda/classes/LeftOf.gif,NaN,0
WinObjC,2873,3,0,modified,0,0,deps/3rdparty/cassowary-0.60/java/cda/classes/LineCC.gif,NaN,0
WinObjC,2873,3,0,modified,0,0,deps/3rdparty/cassowary-0.60/java/cda/classes/MidLineCC.gif,NaN,0
WinObjC,2873,3,0,modified,0,0,deps/3rdparty/cassowary-0.60/java/cda/classes/RectangleCC.gif,NaN,0
WinObjC,2873,3,0,modified,0,0,deps/3rdparty/cassowary-0.60/java/cda/classes/RightAlign.gif,NaN,0
WinObjC,2873,3,0,modified,0,0,deps/3rdparty/cassowary-0.60/java/cda/classes/RightOf.gif,NaN,0
WinObjC,2873,3,0,modified,0,0,deps/3rdparty/cassowary-0.60/java/cda/classes/TopAlign.gif,NaN,0
WinObjC,2873,3,0,modified,0,0,samples/GLKitComplex/GLKitComplex/Data/lobbyxneg.JPG,NaN,0
WinObjC,2873,3,0,modified,0,0,samples/GLKitComplex/GLKitComplex/Data/lobbyxpos.JPG,NaN,0
WinObjC,2873,3,0,modified,0,0,samples/GLKitComplex/GLKitComplex/Data/lobbyyneg.JPG,NaN,0
WinObjC,2873,3,0,modified,0,0,samples/GLKitComplex/GLKitComplex/Data/lobbyypos.JPG,NaN,0
WinObjC,2873,3,0,modified,0,0,samples/GLKitComplex/GLKitComplex/Data/lobbyzneg.JPG,NaN,0
WinObjC,2873,3,0,modified,0,0,samples/GLKitComplex/GLKitComplex/Data/lobbyzpos.JPG,NaN,0
WinObjC,2873,3,0,modified,0,0,samples/WOCCatalog/WOCCatalog/Images/photo1.jpg,low,0
WinObjC,2873,3,0,modified,0,0,samples/WOCCatalog/WOCCatalog/Images/photo10.jpg,low,0
WinObjC,2871,1,8,modified,4,4,tools/ClangCompileTask/ClangCompile.cs,high,1
WinObjC,2871,1,5,modified,3,2,tools/ClangCompileTask/ClangCompile.csproj,low,1
WinObjC,2871,1,25,renamed,7,18,tools/WinObjC.Compiler/ClangCompile.props,medium,1
WinObjC,2871,1,301,added,301,0,tools/WinObjC.Compiler/ClangCompile.targets,low,1
WinObjC,2871,1,10,renamed,5,5,tools/WinObjC.Compiler/ClangCompile.xml,medium,1
WinObjC,2871,1,0,renamed,0,0,tools/WinObjC.Compiler/LLVM/bin/clang.exe,medium,1
WinObjC,2871,1,0,renamed,0,0,tools/WinObjC.Compiler/LLVM/bin/libclang.dll,high,1
WinObjC,2871,1,0,renamed,0,0,tools/WinObjC.Compiler/LLVM/include/clang-c/BuildSystem.h,high,1
WinObjC,2871,1,0,renamed,0,0,tools/WinObjC.Compiler/LLVM/include/clang-c/CXCompilationDatabase.h,high,1
WinObjC,2871,1,0,renamed,0,0,tools/WinObjC.Compiler/LLVM/include/clang-c/CXErrorCode.h,high,1
WinObjC,2871,1,0,renamed,0,0,tools/WinObjC.Compiler/LLVM/include/clang-c/CXString.h,high,1
WinObjC,2871,1,0,renamed,0,0,tools/WinObjC.Compiler/LLVM/include/clang-c/Documentation.h,high,1
WinObjC,2871,1,0,renamed,0,0,tools/WinObjC.Compiler/LLVM/include/clang-c/Index.h,high,1
WinObjC,2871,1,0,renamed,0,0,tools/WinObjC.Compiler/LLVM/include/clang-c/Platform.h,high,1
WinObjC,2871,1,0,renamed,0,0,tools/WinObjC.Compiler/LLVM/include/clang-c/module.modulemap,NaN,1
WinObjC,2871,1,0,renamed,0,0,tools/WinObjC.Compiler/LLVM/include/llvm-c/Analysis.h,high,1
WinObjC,2871,1,0,renamed,0,0,tools/WinObjC.Compiler/LLVM/include/llvm-c/BitReader.h,high,1
WinObjC,2871,1,0,renamed,0,0,tools/WinObjC.Compiler/LLVM/include/llvm-c/BitWriter.h,high,1
WinObjC,2871,1,0,renamed,0,0,tools/WinObjC.Compiler/LLVM/include/llvm-c/Core.h,high,1
WinObjC,2871,1,0,renamed,0,0,tools/WinObjC.Compiler/LLVM/include/llvm-c/DebugInfo.h,high,1
WinObjC,2871,1,0,renamed,0,0,tools/WinObjC.Compiler/LLVM/include/llvm-c/Disassembler.h,high,1
WinObjC,2871,1,0,renamed,0,0,tools/WinObjC.Compiler/LLVM/include/llvm-c/ErrorHandling.h,high,1
WinObjC,2871,1,0,renamed,0,0,tools/WinObjC.Compiler/LLVM/include/llvm-c/ExecutionEngine.h,high,1
WinObjC,2871,1,0,renamed,0,0,tools/WinObjC.Compiler/LLVM/include/llvm-c/IRReader.h,high,1
WinObjC,2871,1,0,renamed,0,0,tools/WinObjC.Compiler/LLVM/include/llvm-c/Initialization.h,high,1
WinObjC,2871,1,0,renamed,0,0,tools/WinObjC.Compiler/LLVM/include/llvm-c/LinkTimeOptimizer.h,high,1
WinObjC,2871,1,0,renamed,0,0,tools/WinObjC.Compiler/LLVM/include/llvm-c/Linker.h,high,1
WinObjC,2871,1,0,renamed,0,0,tools/WinObjC.Compiler/LLVM/include/llvm-c/Object.h,high,1
WinObjC,2871,1,0,renamed,0,0,tools/WinObjC.Compiler/LLVM/include/llvm-c/OrcBindings.h,high,1
WinObjC,2871,1,0,renamed,0,0,tools/WinObjC.Compiler/LLVM/include/llvm-c/Support.h,high,1
WinObjC,2870,1,74,modified,73,1,tools/ClangCompileTask/ClangCompile.cs,high,2
WinObjC,2870,1,10,modified,10,0,tools/msvc/sbclang.targets,low,1
WinObjC,2870,1,79,modified,78,1,tools/msvc/sbclang.xml,medium,1
WinObjC,2869,12,12,modified,9,3,Frameworks/CoreData/NSEntityDescription.mm,medium,0
WinObjC,2869,12,8,modified,4,4,Frameworks/UIKit/UIActionSheet.mm,medium,0
WinObjC,2869,12,4,modified,2,2,Frameworks/UIKit/UIViewController.mm,medium,0
WinObjC,2869,12,2,modified,1,1,Frameworks/include/CFBridgeBase.h,high,0
WinObjC,2869,12,12,modified,6,6,build/OpenGLES/lib/OpenGLESLib.vcxproj,medium,0
WinObjC,2869,12,8,modified,4,4,build/Tests/Benchmark/Framework.Benchmark.vcxproj,medium,0
WinObjC,2869,12,8,modified,4,4,build/Tests/FunctionalTests/FunctionalTests.vcxproj,medium,0
WinObjC,2869,12,6,modified,3,3,build/Tests/UnitTests/Accelerate/Accelerate.UnitTests.vcxproj,medium,0
WinObjC,2869,12,8,modified,4,4,build/Tests/UnitTests/CoreGraphics.Drawing/CoreGraphics.Drawing.UnitTests.vcxproj,medium,0
WinObjC,2869,12,8,modified,4,4,build/Tests/UnitTests/CoreGraphics/CoreGraphics.UnitTests.vcxproj,medium,0
WinObjC,2869,12,8,modified,4,4,build/Tests/UnitTests/CoreImage/CoreImage.UnitTests.vcxproj,medium,0
WinObjC,2869,12,8,modified,4,4,build/Tests/UnitTests/CoreText/CoreText.UnitTests.vcxproj,medium,0
WinObjC,2869,12,8,modified,4,4,build/Tests/UnitTests/ImageIO/ImageIO.UnitTests.vcxproj,medium,0
WinObjC,2869,12,14,added,14,0,contrib/clang/README,NaN,0
WinObjC,2869,12,86,added,86,0,contrib/clang/patches/0001-ObjCGNU-Fix-empty-v3-protocols-being-emitted-two-fie.patch,high,0
WinObjC,2869,12,100,added,100,0,contrib/clang/patches/0002-Allow-equality-comparisons-between-block-pointers-an.patch,high,0
WinObjC,2869,12,120,added,120,0,contrib/clang/patches/0003-AST-correct-mangling-for-SEL-on-MS-ABI.patch,high,0
WinObjC,2869,12,58,added,58,0,contrib/clang/patches/0004-CodeGen-handle-blocks-correctly-when-inalloca-ed.patch,high,0
WinObjC,2869,12,62,added,62,0,contrib/clang/patches/0005-CodeGenObjCXX-handle-inalloca-appropriately-for-msgS.patch,high,0
WinObjC,2869,12,159,added,159,0,contrib/clang/patches/0006-WinEH-Put-funclet-bundles-on-inline-asm-calls.patch,high,0
WinObjC,2869,12,64,added,64,0,contrib/clang/patches/0007-CodeGen-Add-funclet-token-to-ARC-marker.patch,high,0
WinObjC,2869,12,0,added,0,0,contrib/clang/patches/0008-Placeholder-to-delineate-upstream-vs.-Microsoft-chan.patch,high,0
WinObjC,2869,12,115,added,115,0,contrib/clang/patches/0009-ObjC-Improve-the-handling-of-empty-tries-funclet-pad.patch,high,0
WinObjC,2869,12,26,added,26,0,contrib/clang/patches/0010-ObjCGNU-Use-CGF-instead-of-Builder-to-emit-calls-so-.patch,high,0
WinObjC,2869,12,54,added,54,0,contrib/clang/patches/0011-CGException-Add-support-for-funclet-personalities-in.patch,high,0
WinObjC,2869,12,61,added,61,0,contrib/clang/patches/0012-ObjCGNU-Emit-protocols-class-refs-and-const-strings-.patch,high,0
WinObjC,2869,12,65,added,65,0,contrib/clang/patches/0013-ObjCGNU-Improve-MakePropertyEncodingString-s-abstrac.patch,high,0
WinObjC,2869,12,68,added,68,0,contrib/clang/patches/0014-ObjCGNU-Break-module-descriptor-creation-out-of-Modu.patch,high,0
WinObjC,2869,12,31,added,31,0,contrib/clang/patches/0015-SPECULATIVE-Catchall-in-microsoft-personality.patch,high,0
WinObjC,2869,12,25,added,25,0,contrib/clang/patches/0016-SPECULATIVE-emit-catchpads-for-obj-c.patch,high,0
WinObjC,2867,4,4,modified,3,1,build/WinObjC.Frameworks.Core/WinObjC.Frameworks.Core.nuproj,medium,0
WinObjC,2867,4,6,modified,4,2,build/WinObjC.Frameworks.UWP.Core/WinObjC.Frameworks.UWP.Core.nuproj,medium,0
WinObjC,2867,4,10,modified,7,3,build/WinObjC.Frameworks.UWP/WinObjC.Frameworks.UWP.nuproj,medium,0
WinObjC,2867,4,6,modified,4,2,build/WinObjC.Frameworks/WinObjC.Frameworks.nuproj,medium,0
WinObjC,2867,4,8,modified,4,4,tests/testapps/ApplicationGroupFolderRead/ApplicationGroupFolderRead.vsimporter/ApplicationGroupFolderRead-WinStore10/ApplicationGroupFolderRead.vcxproj,medium,0
WinObjC,2867,4,8,modified,4,4,tests/testapps/ApplicationGroupFolderWrite/ApplicationGroupFolderWrite.vsimporter/ApplicationGroupFolderWrite-WinStore10/ApplicationGroupFolderWrite.vcxproj,medium,0
WinObjC,2867,4,8,modified,3,5,tests/unittests/GLKit/GLKitTest.mm,medium,0
WinObjC,2867,4,6,modified,4,2,tools/WinObjC.Language/WinObjC.Language.nuproj,medium,0
WinObjC,2867,4,2,modified,1,1,tools/winmd2objc/UnitTests/UnitTests.vcxproj,medium,0
WinObjC,2866,3,2,modified,1,1,tests/unittests/Foundation/NSPointerFunctionsTests.mm,medium,0
WinObjC,2866,3,15,modified,5,10,tests/unittests/Foundation/NSValueTests.mm,medium,0
WinObjC,2866,3,1978,removed,0,1978,tools/msvc/clang-contrib/include/clang/Basic/Attr.td,NaN,0
WinObjC,2866,3,2314,removed,0,2314,tools/msvc/clang-contrib/lib/CodeGen/CGBlocks.cpp,high,0
WinObjC,2866,3,2858,removed,0,2858,tools/msvc/clang-contrib/lib/CodeGen/CGObjCGNU.cpp,high,0
WinObjC,2864,6,2,modified,1,1,Frameworks/Accelerate/ErrorHandler.mm,medium,0
WinObjC,2864,6,2,modified,1,1,Frameworks/CoreGraphics/CGPath.mm,medium,0
WinObjC,2864,6,284,modified,142,142,Frameworks/UIKit/StarboardXaml/LayerCoordinator.cpp,high,0
WinObjC,2864,6,2,modified,1,1,Frameworks/UIKit/UIGridLayoutInfo.mm,medium,0
WinObjC,2864,6,3,modified,3,0,build/CoreFoundation/dll/CoreFoundation.def,low,0
WinObjC,2864,6,8,modified,4,4,build/Tests/Tests.Shared/Tests.Shared.Logger.vcxproj,medium,0
WinObjC,2864,6,4,modified,0,4,include/Foundation/NSArchiver.h,high,0
WinObjC,2864,6,2,modified,2,0,include/Foundation/NSObjCRuntime.h,high,0
WinObjC,2864,6,4,modified,2,2,include/Foundation/NSRunLoop.h,high,0
WinObjC,2864,6,5,modified,4,1,msvc/ut-build.props,medium,0
WinObjC,2864,6,4,modified,2,2,tools/Logging/include/wil/result.h,high,0
WinObjC,2864,6,225,removed,0,225,tools/legacy/BuildMonitor/Legacy_BuildMonitor.csproj,low,0
WinObjC,2864,6,23,removed,0,23,tools/legacy/BuildMonitor/packages.config,medium,0
WinObjC,2864,6,27,removed,0,27,tools/legacy/BuildMonitor/source.extension.vsixmanifest,NaN,0
WinObjC,2864,6,98,removed,0,98,tools/legacy/ObjectiveC/Legacy_ObjectiveC.csproj,low,0
WinObjC,2864,6,105,removed,0,105,tools/legacy/ObjectiveC/ObjectiveCClassifier.cs,high,0
WinObjC,2864,6,55,removed,0,55,tools/legacy/ObjectiveC/ObjectiveCFormat.cs,high,0
WinObjC,2864,6,159,removed,0,159,tools/legacy/ObjectiveC/ObjectiveCTokenTag.cs,high,0
WinObjC,2864,6,28,removed,0,28,tools/legacy/ObjectiveC/ObjectiveCTokenTypes.cs,high,0
WinObjC,2864,6,40,removed,0,40,tools/legacy/ObjectiveC/ObjectiveCType.cs,high,0
WinObjC,2864,6,31,removed,0,31,tools/legacy/ObjectiveC/Properties/AssemblyInfo.cs,high,0
WinObjC,2864,6,4,removed,0,4,tools/legacy/ObjectiveC/packages.config,medium,0
WinObjC,2864,6,24,removed,0,24,tools/legacy/ObjectiveC/source.extension.vsixmanifest,NaN,0
WinObjC,2864,6,127,removed,0,127,tools/legacy/VSIX/Legacy_ObjectiveCVSIX.csproj,low,0
WinObjC,2864,6,4,removed,0,4,tools/legacy/VSIX/packages.config,medium,0
WinObjC,2864,6,27,removed,0,27,tools/legacy/VSIX/source.extension.vsixmanifest,NaN,0
WinObjC,2864,6,54,modified,0,54,tools/tools.sln,low,0
WinObjC,2864,6,8,modified,4,4,tools/winmd2objc/UnitTests/UnitTests.vcxproj,medium,0
WinObjC,2853,1,7,modified,7,0,scripts/build/Submit-GithubBuildStatus.ps1,high,0
WinObjC,2852,34,91,modified,20,71,tools/vsimporter/xib2nib/src/NIBWriter.cpp,high,0
WinObjC,2852,34,11,modified,8,3,tools/vsimporter/xib2nib/src/NIBWriter.h,high,0
WinObjC,2852,34,101,modified,71,30,tools/vsimporter/xib2nib/src/NSLayoutConstraint.cpp,high,0
WinObjC,2852,34,16,modified,11,5,tools/vsimporter/xib2nib/src/NSLayoutConstraint.h,high,0
WinObjC,2852,34,133,modified,94,39,tools/vsimporter/xib2nib/src/ObjectConverter.cpp,high,0
WinObjC,2852,34,5,modified,5,0,tools/vsimporter/xib2nib/src/ObjectConverter.h,high,0
WinObjC,2852,34,17,modified,0,17,tools/vsimporter/xib2nib/src/UIBarButtonItem.cpp,high,0
WinObjC,2852,34,115,modified,44,71,tools/vsimporter/xib2nib/src/UIButton.cpp,high,0
WinObjC,2852,34,22,modified,6,16,tools/vsimporter/xib2nib/src/UIButton.h,high,0
WinObjC,2852,34,13,modified,10,3,tools/vsimporter/xib2nib/src/UICollectionView.cpp,high,0
WinObjC,2852,34,9,modified,7,2,tools/vsimporter/xib2nib/src/UICollectionView.h,high,0
WinObjC,2852,34,127,added,127,0,tools/vsimporter/xib2nib/src/UICollectionViewFlowLayout.cpp,high,0
WinObjC,2852,34,40,added,40,0,tools/vsimporter/xib2nib/src/UICollectionViewFlowLayout.h,high,0
WinObjC,2852,34,64,modified,41,23,tools/vsimporter/xib2nib/src/UIColor.cpp,high,0
WinObjC,2852,34,19,modified,19,0,tools/vsimporter/xib2nib/src/UIControl.cpp,high,0
WinObjC,2852,34,3,modified,3,0,tools/vsimporter/xib2nib/src/UIControl.h,high,0
WinObjC,2852,34,2,modified,1,1,tools/vsimporter/xib2nib/src/UIImageView.cpp,high,0
WinObjC,2852,34,42,modified,19,23,tools/vsimporter/xib2nib/src/UILabel.cpp,high,0
WinObjC,2852,34,15,modified,15,0,tools/vsimporter/xib2nib/src/UILabel.h,high,0
WinObjC,2852,34,89,added,89,0,tools/vsimporter/xib2nib/src/UILayoutGuide.cpp,high,0
WinObjC,2852,34,28,added,28,0,tools/vsimporter/xib2nib/src/UILayoutGuide.h,high,0
WinObjC,2852,34,111,added,111,0,tools/vsimporter/xib2nib/src/UINibKeyValuePair.cpp,high,0
WinObjC,2852,34,30,added,30,0,tools/vsimporter/xib2nib/src/UINibKeyValuePair.h,high,0
WinObjC,2852,34,28,modified,0,28,tools/vsimporter/xib2nib/src/UIProxyObject.cpp,high,0
WinObjC,2852,34,29,modified,26,3,tools/vsimporter/xib2nib/src/UIRuntimeOutletCollectionConnection.cpp,high,0
WinObjC,2852,34,4,modified,3,1,tools/vsimporter/xib2nib/src/UIRuntimeOutletCollectionConnection.h,high,0
WinObjC,2852,34,24,modified,6,18,tools/vsimporter/xib2nib/src/UIScrollView.cpp,high,0
WinObjC,2852,34,46,modified,32,14,tools/vsimporter/xib2nib/src/UISegment.cpp,high,0
WinObjC,2852,34,13,modified,8,5,tools/vsimporter/xib2nib/src/UISegment.h,high,0
WinObjC,2852,34,72,modified,33,39,tools/vsimporter/xib2nib/src/UISegmentedControl.cpp,high,0
WinObjC,2851,3,4,modified,2,2,Frameworks/AddressBook/ABContactInternal.mm,medium,0
WinObjC,2851,3,4,modified,2,2,Frameworks/AssetsLibrary/ALAssetRepresentation.mm,medium,0
WinObjC,2851,3,6,modified,3,3,Frameworks/AudioToolbox/SystemSound.mm,medium,0
WinObjC,2851,3,2,modified,1,1,Frameworks/CoreFoundation/URL.subproj/CFURLComponents.c,high,0
WinObjC,2851,3,2,modified,1,1,Frameworks/CoreFoundation/URL.subproj/CFURLComponents_URIParser.c,high,0
WinObjC,2851,3,6,modified,3,3,Frameworks/CoreGraphics/DWriteFontBinaryDataCollectionLoader.mm,medium,0
WinObjC,2851,3,4,modified,2,2,Frameworks/CoreGraphics/DWriteWrapper.mm,medium,0
WinObjC,2851,3,2,modified,1,1,Frameworks/CoreImage/CIContext.mm,medium,0
WinObjC,2851,3,8,modified,4,4,Frameworks/CoreText/CTFontManager.mm,medium,0
WinObjC,2851,3,4,modified,2,2,Frameworks/CoreText/CTFramesetter.mm,medium,0
WinObjC,2851,3,14,modified,7,7,Frameworks/CoreText/CTLine.mm,medium,0
WinObjC,2851,3,2,modified,1,1,Frameworks/Foundation/NSArray.mm,medium,0
WinObjC,2851,3,4,modified,2,2,Frameworks/Foundation/NSCFArray.mm,medium,0
WinObjC,2851,3,4,modified,2,2,Frameworks/Foundation/NSCFDictionary.mm,medium,0
WinObjC,2851,3,2,modified,1,1,Frameworks/Foundation/NSCFError.mm,medium,0
WinObjC,2851,3,6,modified,3,3,Frameworks/Foundation/NSCFSet.mm,medium,0
WinObjC,2851,3,4,modified,2,2,Frameworks/Foundation/NSCalendar.mm,medium,0
WinObjC,2851,3,2,modified,1,1,Frameworks/Foundation/NSData.mm,medium,0
WinObjC,2851,3,2,modified,1,1,Frameworks/Foundation/NSDictionary.mm,medium,0
WinObjC,2851,3,4,modified,2,2,Frameworks/Foundation/NSExpressionFunction.mm,medium,0
WinObjC,2851,3,4,modified,2,2,Frameworks/Foundation/NSFileManager.mm,medium,0
WinObjC,2851,3,2,modified,1,1,Frameworks/Foundation/NSInvocation.mm,medium,0
WinObjC,2851,3,4,modified,2,2,Frameworks/Foundation/NSKeyedArchiver.mm,medium,0
WinObjC,2851,3,4,modified,2,2,Frameworks/Foundation/NSRegularExpression.mm,medium,0
WinObjC,2851,3,2,modified,1,1,Frameworks/Foundation/NSSet.mm,medium,0
WinObjC,2851,3,2,modified,1,1,Frameworks/Foundation/NSSortDescriptor.mm,medium,0
WinObjC,2851,3,28,modified,14,14,Frameworks/Foundation/NSString.mm,medium,0
WinObjC,2851,3,2,modified,1,1,Frameworks/Foundation/NSTimer.mm,medium,0
WinObjC,2851,3,6,modified,3,3,Frameworks/Foundation/_NSKeyValueCodingAggregateFunctions.mm,medium,0
WinObjC,2851,3,10,modified,5,5,Frameworks/QuartzCore/CALayer.mm,medium,0
WinObjC,2845,9,30,modified,16,14,Frameworks/UIKit/NSLayoutConstraint.mm,medium,0
WinObjC,2845,9,3,modified,2,1,GitVersion.yml,medium,0
WinObjC,2845,9,12,modified,4,8,README.md,low,0
WinObjC,2845,9,25,added,25,0,build/WinObjC.Frameworks.Core/project.json,medium,0
WinObjC,2845,9,25,added,25,0,build/WinObjC.Frameworks.ThirdParty/project.json,medium,0
WinObjC,2845,9,25,added,25,0,build/WinObjC.Frameworks.UWP.Core/project.json,medium,0
WinObjC,2845,9,25,added,25,0,build/WinObjC.Frameworks.UWP/project.json,medium,0
WinObjC,2845,9,25,added,25,0,build/WinObjC.Frameworks/project.json,medium,0
WinObjC,2845,9,2,modified,1,1,deps/prebuilt/Universal Windows/ARM/ObjCUWPWindowsApplicationModelAppExtensions.dll,high,0
WinObjC,2845,9,2,modified,1,1,deps/prebuilt/Universal Windows/ARM/ObjCUWPWindowsApplicationModelAppExtensions.lib,low,0
WinObjC,2845,9,4,modified,2,2,deps/prebuilt/Universal Windows/ARM/ObjCUWPWindowsApplicationModelAppService.dll,high,0
WinObjC,2845,9,2,modified,1,1,deps/prebuilt/Universal Windows/ARM/ObjCUWPWindowsApplicationModelAppService.lib,low,0
WinObjC,2845,9,4,modified,2,2,deps/prebuilt/Universal Windows/ARM/ObjCUWPWindowsApplicationModelAppointmentsDataProvider.dll,high,0
WinObjC,2845,9,2,modified,1,1,deps/prebuilt/Universal Windows/ARM/ObjCUWPWindowsApplicationModelAppointmentsDataProvider.lib,low,0
WinObjC,2845,9,3,added,3,0,deps/prebuilt/Universal Windows/ARM/ObjCUWPWindowsApplicationModelCalls.dll,high,0
WinObjC,2845,9,3,added,3,0,deps/prebuilt/Universal Windows/ARM/ObjCUWPWindowsApplicationModelCalls.lib,low,0
WinObjC,2845,9,4,modified,2,2,deps/prebuilt/Universal Windows/ARM/ObjCUWPWindowsApplicationModelChat.dll,high,0
WinObjC,2845,9,2,modified,1,1,deps/prebuilt/Universal Windows/ARM/ObjCUWPWindowsApplicationModelChat.lib,low,0
WinObjC,2845,9,4,modified,2,2,deps/prebuilt/Universal Windows/ARM/ObjCUWPWindowsApplicationModelCommunicationBlocking.dll,high,0
WinObjC,2845,9,2,modified,1,1,deps/prebuilt/Universal Windows/ARM/ObjCUWPWindowsApplicationModelCommunicationBlocking.lib,low,0
WinObjC,2845,9,4,modified,2,2,deps/prebuilt/Universal Windows/ARM/ObjCUWPWindowsApplicationModelContactsDataProvider.dll,high,0
WinObjC,2845,9,4,modified,2,2,deps/prebuilt/Universal Windows/ARM/ObjCUWPWindowsApplicationModelContactsDataProvider.lib,low,0
WinObjC,2845,9,4,modified,2,2,deps/prebuilt/Universal Windows/ARM/ObjCUWPWindowsApplicationModelDataTransfer.dll,high,0
WinObjC,2845,9,4,modified,2,2,deps/prebuilt/Universal Windows/ARM/ObjCUWPWindowsApplicationModelDataTransfer.lib,low,0
WinObjC,2845,9,4,modified,2,2,deps/prebuilt/Universal Windows/ARM/ObjCUWPWindowsApplicationModelDataTransferDragDrop.dll,high,0
WinObjC,2845,9,2,modified,1,1,deps/prebuilt/Universal Windows/ARM/ObjCUWPWindowsApplicationModelDataTransferDragDrop.lib,low,0
WinObjC,2845,9,4,modified,2,2,deps/prebuilt/Universal Windows/ARM/ObjCUWPWindowsApplicationModelDataTransferDragDropCore.dll,high,0
WinObjC,2845,9,2,modified,1,1,deps/prebuilt/Universal Windows/ARM/ObjCUWPWindowsApplicationModelDataTransferDragDropCore.lib,low,0
WinObjC,2845,9,4,modified,2,2,deps/prebuilt/Universal Windows/ARM/ObjCUWPWindowsApplicationModelEmailDataProvider.dll,high,0
WinObjC,2845,9,2,modified,1,1,deps/prebuilt/Universal Windows/ARM/ObjCUWPWindowsApplicationModelEmailDataProvider.lib,low,0
WinObjC,2843,3,30,modified,16,14,Frameworks/UIKit/NSLayoutConstraint.mm,medium,0
WinObjC,2843,3,17,modified,2,15,tools/ClangCompileTask/ClangCompile.cs,high,2
WinObjC,2843,3,0,renamed,0,0,tools/msvc/LLVM/bin/1033/clui.dll,high,0
WinObjC,2843,3,0,renamed,0,0,tools/msvc/LLVM/bin/arm/c2.dll,high,0
WinObjC,2843,3,0,renamed,0,0,tools/msvc/LLVM/bin/clang++.exe,medium,0
WinObjC,2843,3,0,renamed,0,0,tools/msvc/LLVM/bin/clang-cl.exe,medium,0
WinObjC,2843,3,0,renamed,0,0,tools/msvc/LLVM/bin/clang-format.exe,medium,0
WinObjC,2843,3,0,renamed,0,0,tools/msvc/LLVM/bin/clang.exe,medium,0
WinObjC,2843,3,0,renamed,0,0,tools/msvc/LLVM/bin/msobj140.dll,high,0
WinObjC,2843,3,0,renamed,0,0,tools/msvc/LLVM/bin/mspdb140.dll,high,0
WinObjC,2843,3,0,renamed,0,0,tools/msvc/LLVM/bin/mspdbcore.dll,high,0
WinObjC,2843,3,0,renamed,0,0,tools/msvc/LLVM/bin/mspdbsrv.exe,medium,0
WinObjC,2843,3,0,renamed,0,0,tools/msvc/LLVM/bin/mspft140.dll,high,0
WinObjC,2843,3,0,renamed,0,0,tools/msvc/LLVM/bin/msvcdis140.dll,high,0
WinObjC,2843,3,0,renamed,0,0,tools/msvc/LLVM/bin/x86/c2.dll,high,0
WinObjC,2843,3,0,renamed,0,0,tools/msvc/LLVM/include/clang-c/BuildSystem.h,high,0
WinObjC,2843,3,0,renamed,0,0,tools/msvc/LLVM/include/clang-c/CXCompilationDatabase.h,high,0
WinObjC,2843,3,0,renamed,0,0,tools/msvc/LLVM/include/clang-c/CXErrorCode.h,high,0
WinObjC,2843,3,0,renamed,0,0,tools/msvc/LLVM/include/clang-c/CXString.h,high,0
WinObjC,2843,3,0,renamed,0,0,tools/msvc/LLVM/include/clang-c/Documentation.h,high,0
WinObjC,2843,3,0,renamed,0,0,tools/msvc/LLVM/include/clang-c/Index.h,high,0
WinObjC,2843,3,0,renamed,0,0,tools/msvc/LLVM/include/clang-c/Platform.h,high,0
WinObjC,2843,3,0,renamed,0,0,tools/msvc/LLVM/include/clang-c/module.modulemap,NaN,0
WinObjC,2843,3,0,renamed,0,0,tools/msvc/LLVM/include/llvm-c/Analysis.h,high,0
WinObjC,2843,3,0,renamed,0,0,tools/msvc/LLVM/include/llvm-c/BitReader.h,high,0
WinObjC,2843,3,0,renamed,0,0,tools/msvc/LLVM/include/llvm-c/BitWriter.h,high,0
WinObjC,2843,3,0,renamed,0,0,tools/msvc/LLVM/include/llvm-c/Core.h,high,0
WinObjC,2843,3,0,renamed,0,0,tools/msvc/LLVM/include/llvm-c/Disassembler.h,high,0
WinObjC,2843,3,0,renamed,0,0,tools/msvc/LLVM/include/llvm-c/ExecutionEngine.h,high,0
WinObjC,2843,3,0,renamed,0,0,tools/msvc/LLVM/include/llvm-c/IRReader.h,high,0
WinObjC,2839,1,12,modified,4,8,README.md,low,0
WinObjC,2836,1,4,modified,2,2,tools/winmd2objc/lib/CodeGen.cpp,high,0
WinObjC,2835,1,2,modified,1,1,deps/prebuilt/Universal Windows/ARM/ObjCUWPWindowsApplicationModelAppExtensions.dll,high,0
WinObjC,2835,1,2,modified,1,1,deps/prebuilt/Universal Windows/ARM/ObjCUWPWindowsApplicationModelAppExtensions.lib,low,0
WinObjC,2835,1,4,modified,2,2,deps/prebuilt/Universal Windows/ARM/ObjCUWPWindowsApplicationModelAppService.dll,high,0
WinObjC,2835,1,2,modified,1,1,deps/prebuilt/Universal Windows/ARM/ObjCUWPWindowsApplicationModelAppService.lib,low,0
WinObjC,2835,1,4,modified,2,2,deps/prebuilt/Universal Windows/ARM/ObjCUWPWindowsApplicationModelAppointmentsDataProvider.dll,high,0
WinObjC,2835,1,2,modified,1,1,deps/prebuilt/Universal Windows/ARM/ObjCUWPWindowsApplicationModelAppointmentsDataProvider.lib,low,0
WinObjC,2835,1,3,added,3,0,deps/prebuilt/Universal Windows/ARM/ObjCUWPWindowsApplicationModelCalls.dll,high,0
WinObjC,2835,1,3,added,3,0,deps/prebuilt/Universal Windows/ARM/ObjCUWPWindowsApplicationModelCalls.lib,low,0
WinObjC,2835,1,4,modified,2,2,deps/prebuilt/Universal Windows/ARM/ObjCUWPWindowsApplicationModelChat.dll,high,0
WinObjC,2835,1,2,modified,1,1,deps/prebuilt/Universal Windows/ARM/ObjCUWPWindowsApplicationModelChat.lib,low,0
WinObjC,2835,1,4,modified,2,2,deps/prebuilt/Universal Windows/ARM/ObjCUWPWindowsApplicationModelCommunicationBlocking.dll,high,0
WinObjC,2835,1,2,modified,1,1,deps/prebuilt/Universal Windows/ARM/ObjCUWPWindowsApplicationModelCommunicationBlocking.lib,low,0
WinObjC,2835,1,4,modified,2,2,deps/prebuilt/Universal Windows/ARM/ObjCUWPWindowsApplicationModelContactsDataProvider.dll,high,0
WinObjC,2835,1,4,modified,2,2,deps/prebuilt/Universal Windows/ARM/ObjCUWPWindowsApplicationModelContactsDataProvider.lib,low,0
WinObjC,2835,1,4,modified,2,2,deps/prebuilt/Universal Windows/ARM/ObjCUWPWindowsApplicationModelDataTransfer.dll,high,0
WinObjC,2835,1,4,modified,2,2,deps/prebuilt/Universal Windows/ARM/ObjCUWPWindowsApplicationModelDataTransfer.lib,low,0
WinObjC,2835,1,4,modified,2,2,deps/prebuilt/Universal Windows/ARM/ObjCUWPWindowsApplicationModelDataTransferDragDrop.dll,high,0
WinObjC,2835,1,2,modified,1,1,deps/prebuilt/Universal Windows/ARM/ObjCUWPWindowsApplicationModelDataTransferDragDrop.lib,low,0
WinObjC,2835,1,4,modified,2,2,deps/prebuilt/Universal Windows/ARM/ObjCUWPWindowsApplicationModelDataTransferDragDropCore.dll,high,0
WinObjC,2835,1,2,modified,1,1,deps/prebuilt/Universal Windows/ARM/ObjCUWPWindowsApplicationModelDataTransferDragDropCore.lib,low,0
WinObjC,2835,1,4,modified,2,2,deps/prebuilt/Universal Windows/ARM/ObjCUWPWindowsApplicationModelEmailDataProvider.dll,high,0
WinObjC,2835,1,2,modified,1,1,deps/prebuilt/Universal Windows/ARM/ObjCUWPWindowsApplicationModelEmailDataProvider.lib,low,0
WinObjC,2835,1,4,modified,2,2,deps/prebuilt/Universal Windows/ARM/ObjCUWPWindowsApplicationModelExtendedExecution.dll,high,0
WinObjC,2835,1,2,modified,1,1,deps/prebuilt/Universal Windows/ARM/ObjCUWPWindowsApplicationModelExtendedExecution.lib,low,0
WinObjC,2835,1,2,modified,1,1,deps/prebuilt/Universal Windows/ARM/ObjCUWPWindowsApplicationModelExtendedExecutionForeground.dll,high,0
WinObjC,2835,1,2,modified,1,1,deps/prebuilt/Universal Windows/ARM/ObjCUWPWindowsApplicationModelExtendedExecutionForeground.lib,low,0
WinObjC,2835,1,4,modified,2,2,deps/prebuilt/Universal Windows/ARM/ObjCUWPWindowsApplicationModelLockScreen.dll,high,0
WinObjC,2835,1,2,modified,1,1,deps/prebuilt/Universal Windows/ARM/ObjCUWPWindowsApplicationModelLockScreen.lib,low,0
WinObjC,2835,1,3,added,3,0,deps/prebuilt/Universal Windows/ARM/ObjCUWPWindowsApplicationModelPayments.dll,high,0
WinObjC,2835,1,3,added,3,0,deps/prebuilt/Universal Windows/ARM/ObjCUWPWindowsApplicationModelPayments.lib,low,0
WinObjC,2833,1,3,modified,2,1,tools/msvc/sbclang.targets,low,1
WinObjC,2832,1,3,modified,2,1,GitVersion.yml,medium,0
WinObjC,2828,1,25,added,25,0,build/WinObjC.Frameworks.Core/project.json,medium,0
WinObjC,2828,1,25,added,25,0,build/WinObjC.Frameworks.ThirdParty/project.json,medium,0
WinObjC,2828,1,25,added,25,0,build/WinObjC.Frameworks.UWP.Core/project.json,medium,0
WinObjC,2828,1,25,added,25,0,build/WinObjC.Frameworks.UWP/project.json,medium,0
WinObjC,2828,1,25,added,25,0,build/WinObjC.Frameworks/project.json,medium,0
WinObjC,2825,8,63,modified,63,0,Frameworks/CoreFoundation/PlugIn.subproj/CFBundle_Locale.c,high,0
WinObjC,2825,8,3,modified,2,1,build/Tests/UnitTests/Foundation.WindowsOnly/Foundation.WindowsOnly.UnitTests.vcxproj,medium,0
WinObjC,2825,8,3,modified,2,1,build/Tests/UnitTests/Foundation.WindowsOnly/Foundation.WindowsOnly.UnitTests.vcxproj.filters,medium,0
WinObjC,2825,8,3,modified,2,1,build/Tests/UnitTests/Foundation/Foundation.UnitTests.vcxproj,medium,0
WinObjC,2825,8,3,modified,2,1,build/Tests/UnitTests/Foundation/Foundation.UnitTests.vcxproj.filters,medium,0
WinObjC,2825,8,3,modified,2,1,build/Tests/UnitTests/WOCStdLib/WOCStdLib.UnitTests.vcxproj,medium,0
WinObjC,2825,8,29,modified,10,19,deps/3rdparty/libdispatch/build/libdispatch.vcxproj,medium,0
WinObjC,2825,8,16,added,16,0,deps/3rdparty/libdispatch/build/project.json,medium,0
WinObjC,2825,8,215,modified,214,1,deps/3rdparty/libdispatch/dispatch/queue.h,high,0
WinObjC,2825,8,2,modified,2,0,deps/3rdparty/libdispatch/src/interop.c,high,0
WinObjC,2825,8,129,modified,129,0,deps/3rdparty/libdispatch/src/queue.c,high,0
WinObjC,2825,8,20,modified,19,1,deps/3rdparty/libdispatch/src/queue_internal.h,high,0
WinObjC,2825,8,2,modified,2,0,deps/3rdparty/libdispatch/src/queue_kevent.c,high,0
WinObjC,2825,8,2,modified,1,1,msvc/sdk-build.props,medium,0
WinObjC,2825,8,11,added,11,0,samples/WOCCatalog/WOCCatalog.vsimporter/WOCCatalog-WinStore10/Base.lproj/Localizable.strings,NaN,0
WinObjC,2825,8,30,modified,25,5,samples/WOCCatalog/WOCCatalog.vsimporter/WOCCatalog-WinStore10/WOCCatalog.vcxproj,medium,0
WinObjC,2825,8,27,modified,25,2,samples/WOCCatalog/WOCCatalog.vsimporter/WOCCatalog-WinStore10/WOCCatalog.vcxproj.filters,medium,0
WinObjC,2825,8,11,added,11,0,samples/WOCCatalog/WOCCatalog.vsimporter/WOCCatalog-WinStore10/de.lproj/Localizable.strings,NaN,0
WinObjC,2825,8,11,added,11,0,samples/WOCCatalog/WOCCatalog.vsimporter/WOCCatalog-WinStore10/es_MX.lproj/Localizable.strings,NaN,0
WinObjC,2825,8,11,added,11,0,samples/WOCCatalog/WOCCatalog.vsimporter/WOCCatalog-WinStore10/zh-Hant-TW.lproj/Localizable.strings,NaN,0
WinObjC,2825,8,11,added,11,0,samples/WOCCatalog/WOCCatalog.vsimporter/WOCCatalog-WinStore10/zh.lproj/Localizable.strings,NaN,0
WinObjC,2825,8,21,added,21,0,samples/WOCCatalog/WOCCatalog/LocalizationViewController.h,high,0
WinObjC,2825,8,82,added,82,0,samples/WOCCatalog/WOCCatalog/LocalizationViewController.m,high,0
WinObjC,2825,8,6,modified,5,1,samples/WOCCatalog/WOCCatalog/MainViewController.m,high,0
WinObjC,2825,8,210,added,210,0,tests/UnitTests/Foundation/DispatchTests.mm,medium,0
WinObjC,2825,8,77,added,77,0,tests/UnitTests/Foundation/WindowsOnly/BundleInternalTests.mm,medium,0
WinObjC,2825,8,79,added,79,0,tests/UnitTests/WOCStdLib/OSSpinLockTest.mm,medium,0
WinObjC,2825,8,2,modified,1,1,tests/unittests/Foundation/NSNullTests.mm,medium,0
WinObjC,2825,8,3,modified,3,0,tools/WOCStdLib/dll/WOCStdLib.def,low,0
WinObjC,2825,8,35,added,35,0,tools/WOCStdLib/lib/OSSpinLock.cpp,high,0
WinObjC,2824,6,63,modified,63,0,Frameworks/CoreFoundation/PlugIn.subproj/CFBundle_Locale.c,high,0
WinObjC,2824,6,3,modified,2,1,build/Tests/UnitTests/Foundation.WindowsOnly/Foundation.WindowsOnly.UnitTests.vcxproj,medium,0
WinObjC,2824,6,3,modified,2,1,build/Tests/UnitTests/Foundation.WindowsOnly/Foundation.WindowsOnly.UnitTests.vcxproj.filters,medium,0
WinObjC,2824,6,11,added,11,0,samples/WOCCatalog/WOCCatalog.vsimporter/WOCCatalog-WinStore10/Base.lproj/Localizable.strings,NaN,0
WinObjC,2824,6,30,modified,25,5,samples/WOCCatalog/WOCCatalog.vsimporter/WOCCatalog-WinStore10/WOCCatalog.vcxproj,medium,0
WinObjC,2824,6,27,modified,25,2,samples/WOCCatalog/WOCCatalog.vsimporter/WOCCatalog-WinStore10/WOCCatalog.vcxproj.filters,medium,0
WinObjC,2824,6,11,added,11,0,samples/WOCCatalog/WOCCatalog.vsimporter/WOCCatalog-WinStore10/de.lproj/Localizable.strings,NaN,0
WinObjC,2824,6,11,added,11,0,samples/WOCCatalog/WOCCatalog.vsimporter/WOCCatalog-WinStore10/es_MX.lproj/Localizable.strings,NaN,0
WinObjC,2824,6,11,added,11,0,samples/WOCCatalog/WOCCatalog.vsimporter/WOCCatalog-WinStore10/zh-Hant-TW.lproj/Localizable.strings,NaN,0
WinObjC,2824,6,11,added,11,0,samples/WOCCatalog/WOCCatalog.vsimporter/WOCCatalog-WinStore10/zh.lproj/Localizable.strings,NaN,0
WinObjC,2824,6,21,added,21,0,samples/WOCCatalog/WOCCatalog/LocalizationViewController.h,high,0
WinObjC,2824,6,82,added,82,0,samples/WOCCatalog/WOCCatalog/LocalizationViewController.m,high,0
WinObjC,2824,6,6,modified,5,1,samples/WOCCatalog/WOCCatalog/MainViewController.m,high,0
WinObjC,2824,6,77,added,77,0,tests/UnitTests/Foundation/WindowsOnly/BundleInternalTests.mm,medium,0
WinObjC,2822,3,2,modified,1,1,deps/3rdparty/libdispatch/src/queue.c,high,0
WinObjC,2822,3,208,modified,109,99,tests/UnitTests/Foundation/DispatchTests.mm,medium,0
WinObjC,2822,3,2,modified,1,1,tools/deps/prebuilt/Universal Windows/ARM/Debug/libdispatch.dll,high,0
WinObjC,2822,3,4,modified,2,2,tools/deps/prebuilt/Universal Windows/ARM/Debug/libdispatch.pdb,low,0
WinObjC,2822,3,2,modified,1,1,tools/deps/prebuilt/Universal Windows/ARM/Release/libdispatch.dll,high,0
WinObjC,2822,3,2,modified,1,1,tools/deps/prebuilt/Universal Windows/ARM/Release/libdispatch.pdb,low,0
WinObjC,2822,3,2,modified,1,1,tools/deps/prebuilt/Universal Windows/x86/Debug/libdispatch.dll,high,0
WinObjC,2822,3,4,modified,2,2,tools/deps/prebuilt/Universal Windows/x86/Debug/libdispatch.pdb,low,0
WinObjC,2822,3,4,modified,2,2,tools/deps/prebuilt/Universal Windows/x86/Release/libdispatch.dll,high,0
WinObjC,2822,3,2,modified,1,1,tools/deps/prebuilt/Universal Windows/x86/Release/libdispatch.pdb,low,0
WinObjC,2821,1,2,modified,1,1,tests/unittests/Foundation/NSNullTests.mm,medium,0
WinObjC,2820,5,3,modified,2,1,build/Tests/UnitTests/WOCStdLib/WOCStdLib.UnitTests.vcxproj,medium,0
WinObjC,2820,5,79,added,79,0,tests/UnitTests/WOCStdLib/OSSpinLockTest.mm,medium,0
WinObjC,2820,5,3,modified,3,0,tools/WOCStdLib/dll/WOCStdLib.def,low,0
WinObjC,2820,5,35,added,35,0,tools/WOCStdLib/lib/OSSpinLock.cpp,high,0
WinObjC,2820,5,6,modified,2,4,tools/WOCStdLib/lib/WOCStdLibLib.vcxproj,medium,0
WinObjC,2820,5,10,modified,10,0,tools/include/WOCStdLib/libkern/OSAtomic.h,high,0
WinObjC,2816,3,3,modified,2,1,build/Tests/UnitTests/Foundation/Foundation.UnitTests.vcxproj,medium,0
WinObjC,2816,3,3,modified,2,1,build/Tests/UnitTests/Foundation/Foundation.UnitTests.vcxproj.filters,medium,0
WinObjC,2816,3,29,modified,10,19,deps/3rdparty/libdispatch/build/libdispatch.vcxproj,medium,0
WinObjC,2816,3,16,added,16,0,deps/3rdparty/libdispatch/build/project.json,medium,0
WinObjC,2816,3,215,modified,214,1,deps/3rdparty/libdispatch/dispatch/queue.h,high,0
WinObjC,2816,3,2,modified,2,0,deps/3rdparty/libdispatch/src/interop.c,high,0
WinObjC,2816,3,129,modified,129,0,deps/3rdparty/libdispatch/src/queue.c,high,0
WinObjC,2816,3,20,modified,19,1,deps/3rdparty/libdispatch/src/queue_internal.h,high,0
WinObjC,2816,3,2,modified,2,0,deps/3rdparty/libdispatch/src/queue_kevent.c,high,0
WinObjC,2816,3,2,modified,1,1,msvc/sdk-build.props,medium,0
WinObjC,2816,3,200,added,200,0,tests/UnitTests/Foundation/DispatchTests.mm,medium,0
WinObjC,2816,3,4,modified,2,2,tools/deps/prebuilt/Universal Windows/ARM/Debug/libdispatch.dll,high,0
WinObjC,2816,3,4,modified,2,2,tools/deps/prebuilt/Universal Windows/ARM/Debug/libdispatch.lib,low,0
WinObjC,2816,3,4,modified,2,2,tools/deps/prebuilt/Universal Windows/ARM/Debug/libdispatch.pdb,low,0
WinObjC,2816,3,4,modified,2,2,tools/deps/prebuilt/Universal Windows/ARM/Release/libdispatch.dll,high,0
WinObjC,2816,3,4,modified,2,2,tools/deps/prebuilt/Universal Windows/ARM/Release/libdispatch.lib,low,0
WinObjC,2816,3,4,modified,2,2,tools/deps/prebuilt/Universal Windows/ARM/Release/libdispatch.pdb,low,0
WinObjC,2816,3,4,modified,2,2,tools/deps/prebuilt/Universal Windows/x86/Debug/libdispatch.dll,high,0
WinObjC,2816,3,4,modified,2,2,tools/deps/prebuilt/Universal Windows/x86/Debug/libdispatch.lib,low,0
WinObjC,2816,3,4,modified,2,2,tools/deps/prebuilt/Universal Windows/x86/Debug/libdispatch.pdb,low,0
WinObjC,2816,3,4,modified,2,2,tools/deps/prebuilt/Universal Windows/x86/Release/libdispatch.dll,high,0
WinObjC,2816,3,4,modified,2,2,tools/deps/prebuilt/Universal Windows/x86/Release/libdispatch.lib,low,0
WinObjC,2816,3,4,modified,2,2,tools/deps/prebuilt/Universal Windows/x86/Release/libdispatch.pdb,low,0
WinObjC,2816,3,215,modified,214,1,tools/deps/prebuilt/include/dispatch/queue.h,high,0
WinObjC,2816,3,117,modified,69,48,tools/deps/prebuilt/include/dispatch/queue_internal.h,high,0
WinObjC,2814,10,12,modified,1,11,Frameworks/Foundation/NSArray.mm,medium,0
WinObjC,2814,10,12,modified,10,2,Frameworks/Foundation/NSCFArray.mm,medium,0
WinObjC,2814,10,12,modified,12,0,Frameworks/Foundation/NSCFCollectionSupport.h,high,0
WinObjC,2814,10,71,modified,34,37,Frameworks/Foundation/NSMutableArray.mm,medium,0
WinObjC,2814,10,2,modified,1,1,Frameworks/UIKit.Xaml/TextField.xaml.cpp,high,0
WinObjC,2814,10,10,modified,5,5,deps/3rdparty/cassowary-0.60/cassowary-0.60-Windows.vcxproj,medium,0
WinObjC,2814,10,0,modified,0,0,deps/3rdparty/openal-soft-winphone/winrt.vs2012/example.winrt/example.winrt_TemporaryKey.pfx,low,0
WinObjC,2814,10,0,modified,0,0,deps/3rdparty/openal-soft-winphone/winrt.vs2013/winrt_and_wp_v8.0/example.winrt/example.winrt_TemporaryKey.pfx,low,0
WinObjC,2814,10,0,modified,0,0,deps/3rdparty/openal-soft-winphone/winrt.vs2013/winrt_and_wp_v8.1/example_xaml/example_xaml.Windows/example_xaml.Windows_TemporaryKey.pfx,low,0
WinObjC,2814,10,0,modified,0,0,deps/3rdparty/openal-soft-winphone/winrt.vs2015/example_xaml/example_xaml_TemporaryKey.pfx,low,0
WinObjC,2814,10,4,modified,2,2,deps/prebuilt/Universal Windows/ARM/cassowary-0.60-Debug.lib,low,0
WinObjC,2814,10,4,modified,2,2,deps/prebuilt/Universal Windows/ARM/cassowary-0.60-Debug.pdb,low,0
WinObjC,2814,10,4,modified,2,2,deps/prebuilt/Universal Windows/ARM/cassowary-0.60.lib,low,0
WinObjC,2814,10,4,modified,2,2,deps/prebuilt/Universal Windows/ARM/cassowary-0.60.pdb,low,0
WinObjC,2814,10,4,modified,2,2,deps/prebuilt/Universal Windows/x86/cassowary-0.60-Debug.lib,low,0
WinObjC,2814,10,4,modified,2,2,deps/prebuilt/Universal Windows/x86/cassowary-0.60-Debug.pdb,low,0
WinObjC,2814,10,4,modified,2,2,deps/prebuilt/Universal Windows/x86/cassowary-0.60.lib,low,0
WinObjC,2814,10,4,modified,2,2,deps/prebuilt/Universal Windows/x86/cassowary-0.60.pdb,low,0
WinObjC,2814,10,2,modified,1,1,include/Foundation/NSMutableArray.h,high,0
WinObjC,2814,10,2,modified,1,1,msvc/sdk-build.props,medium,0
WinObjC,2814,10,2,modified,1,1,msvc/ut-build.props,medium,0
WinObjC,2814,10,2,modified,1,1,samples/CoreAnimationTest/CoreAnimationTest.vsimporter/CoreAnimationTest-WinStore10/CoreAnimationTest.vcxproj,medium,0
WinObjC,2814,10,0,modified,0,0,samples/CoreAnimationTest/CoreAnimationTest.vsimporter/CoreAnimationTest-WinStore10/CoreAnimationTest_TemporaryKey.pfx,low,0
WinObjC,2814,10,2,modified,1,1,samples/GLKitComplex/GLKitComplex.vsimporter/GLKitComplex-WinStore10/GLKitComplex.vcxproj,medium,0
WinObjC,2814,10,0,modified,0,0,samples/GLKitComplex/GLKitComplex.vsimporter/GLKitComplex-WinStore10/GLKitComplex_TemporaryKey.pfx,low,0
WinObjC,2814,10,2,modified,1,1,samples/HelloGLKit/HelloGLKit.vsimporter/HelloGLKit-WinStore10/HelloGLKit.vcxproj,medium,0
WinObjC,2814,10,0,modified,0,0,samples/HelloGLKit/HelloGLKit.vsimporter/HelloGLKit-WinStore10/HelloGLKit_TemporaryKey.pfx,low,0
WinObjC,2814,10,2,modified,1,1,samples/HelloOpenGL/HelloOpenGL.vsimporter/HelloOpenGL-WinStore10/HelloOpenGL.vcxproj,medium,0
WinObjC,2814,10,0,modified,0,0,samples/HelloOpenGL/HelloOpenGL.vsimporter/HelloOpenGL-WinStore10/HelloOpenGL_TemporaryKey.pfx,low,0
WinObjC,2814,10,2,modified,1,1,samples/HelloUI/HelloUI.vsimporter/HelloUI-WinStore10/HelloUI.vcxproj,medium,0
WinObjC,2811,2,0,modified,0,0,deps/3rdparty/openal-soft-winphone/winrt.vs2012/example.winrt/example.winrt_TemporaryKey.pfx,low,0
WinObjC,2811,2,0,modified,0,0,deps/3rdparty/openal-soft-winphone/winrt.vs2013/winrt_and_wp_v8.0/example.winrt/example.winrt_TemporaryKey.pfx,low,0
WinObjC,2811,2,0,modified,0,0,deps/3rdparty/openal-soft-winphone/winrt.vs2013/winrt_and_wp_v8.1/example_xaml/example_xaml.Windows/example_xaml.Windows_TemporaryKey.pfx,low,0
WinObjC,2811,2,0,modified,0,0,deps/3rdparty/openal-soft-winphone/winrt.vs2015/example_xaml/example_xaml_TemporaryKey.pfx,low,0
WinObjC,2811,2,2,modified,1,1,samples/CoreAnimationTest/CoreAnimationTest.vsimporter/CoreAnimationTest-WinStore10/CoreAnimationTest.vcxproj,medium,0
WinObjC,2811,2,0,modified,0,0,samples/CoreAnimationTest/CoreAnimationTest.vsimporter/CoreAnimationTest-WinStore10/CoreAnimationTest_TemporaryKey.pfx,low,0
WinObjC,2811,2,2,modified,1,1,samples/GLKitComplex/GLKitComplex.vsimporter/GLKitComplex-WinStore10/GLKitComplex.vcxproj,medium,0
WinObjC,2811,2,0,modified,0,0,samples/GLKitComplex/GLKitComplex.vsimporter/GLKitComplex-WinStore10/GLKitComplex_TemporaryKey.pfx,low,0
WinObjC,2811,2,2,modified,1,1,samples/HelloGLKit/HelloGLKit.vsimporter/HelloGLKit-WinStore10/HelloGLKit.vcxproj,medium,0
WinObjC,2811,2,0,modified,0,0,samples/HelloGLKit/HelloGLKit.vsimporter/HelloGLKit-WinStore10/HelloGLKit_TemporaryKey.pfx,low,0
WinObjC,2811,2,2,modified,1,1,samples/HelloOpenGL/HelloOpenGL.vsimporter/HelloOpenGL-WinStore10/HelloOpenGL.vcxproj,medium,0
WinObjC,2811,2,0,modified,0,0,samples/HelloOpenGL/HelloOpenGL.vsimporter/HelloOpenGL-WinStore10/HelloOpenGL_TemporaryKey.pfx,low,0
WinObjC,2811,2,2,modified,1,1,samples/HelloUI/HelloUI.vsimporter/HelloUI-WinStore10/HelloUI.vcxproj,medium,0
WinObjC,2811,2,0,modified,0,0,samples/HelloUI/HelloUI.vsimporter/HelloUI-WinStore10/HelloUI_TemporaryKey.pfx,low,0
WinObjC,2811,2,0,modified,0,0,samples/KVOPerf/KVOPerf.vsimporter/KVOPerf-WinStore10/KVOPerf_TemporaryKey.pfx,low,0
WinObjC,2811,2,2,modified,1,1,samples/WOCCatalog/WOCCatalog.vsimporter/WOCCatalog-WinStore10/WOCCatalog.vcxproj,medium,0
WinObjC,2811,2,0,modified,0,0,samples/WOCCatalog/WOCCatalog.vsimporter/WOCCatalog-WinStore10/WOCCatalog_TemporaryKey.pfx,low,0
WinObjC,2811,2,0,modified,0,0,samples/WinRTSample/WinRTSample.vsimporter/WinRTSample-WinStore10/WinRTSample_TemporaryKey.pfx,low,0
WinObjC,2811,2,2,modified,1,1,samples/XAMLCatalog/XAMLCatalog.vsimporter/XAMLCatalog-WinStore10/XAMLCatalog.vcxproj,medium,0
WinObjC,2811,2,0,modified,0,0,samples/XAMLCatalog/XAMLCatalog.vsimporter/XAMLCatalog-WinStore10/XAMLCatalog_TemporaryKey.pfx,low,0
WinObjC,2811,2,2,modified,1,1,samples/XAMLTest/XamlTest.vsimporter/XamlTest-WinStore10/XamlTest.vcxproj,medium,0
WinObjC,2811,2,0,modified,0,0,samples/XAMLTest/XamlTest.vsimporter/XamlTest-WinStore10/XamlTest_TemporaryKey.pfx,low,0
WinObjC,2811,2,0,modified,0,0,tests/apps/TemporaryKey.pfx,low,0
WinObjC,2811,2,2,modified,1,1,tests/testapps/AddressBookSample/AddressBookSample.vsimporter/AddressBookSample-WinStore10/AddressBookSample.vcxproj,medium,0
WinObjC,2811,2,0,modified,0,0,tests/testapps/AddressBookSample/AddressBookSample.vsimporter/AddressBookSample-WinStore10/AddressBookSample_TemporaryKey.pfx,low,0
WinObjC,2811,2,2,modified,1,1,tests/testapps/ApplicationGroupFolderRead/ApplicationGroupFolderRead.vsimporter/ApplicationGroupFolderRead-WinStore10/ApplicationGroupFolderRead.vcxproj,medium,0
WinObjC,2811,2,0,modified,0,0,tests/testapps/ApplicationGroupFolderRead/ApplicationGroupFolderRead.vsimporter/ApplicationGroupFolderRead-WinStore10/ApplicationGroupFolderRead_TemporaryKey.pfx,low,0
WinObjC,2811,2,2,modified,1,1,tests/testapps/ApplicationGroupFolderWrite/ApplicationGroupFolderWrite.vsimporter/ApplicationGroupFolderWrite-WinStore10/ApplicationGroupFolderWrite.vcxproj,medium,0
WinObjC,2811,2,0,modified,0,0,tests/testapps/ApplicationGroupFolderWrite/ApplicationGroupFolderWrite.vsimporter/ApplicationGroupFolderWrite-WinStore10/ApplicationGroupFolderWrite_TemporaryKey.pfx,low,0
WinObjC,2811,2,2,modified,1,1,tests/testapps/CGCatalog/CGCatalog.vsimporter/CGCatalog-WinStore10/CGCatalog.vcxproj,medium,0
WinObjC,2809,1,2,modified,1,1,scripts/init/Initialize-NuGet.ps1,high,0
WinObjC,2804,1,10,modified,5,5,deps/3rdparty/cassowary-0.60/cassowary-0.60-Windows.vcxproj,medium,0
WinObjC,2804,1,4,modified,2,2,deps/prebuilt/Universal Windows/ARM/cassowary-0.60-Debug.lib,low,0
WinObjC,2804,1,4,modified,2,2,deps/prebuilt/Universal Windows/ARM/cassowary-0.60-Debug.pdb,low,0
WinObjC,2804,1,4,modified,2,2,deps/prebuilt/Universal Windows/ARM/cassowary-0.60.lib,low,0
WinObjC,2804,1,4,modified,2,2,deps/prebuilt/Universal Windows/ARM/cassowary-0.60.pdb,low,0
WinObjC,2804,1,4,modified,2,2,deps/prebuilt/Universal Windows/x86/cassowary-0.60-Debug.lib,low,0
WinObjC,2804,1,4,modified,2,2,deps/prebuilt/Universal Windows/x86/cassowary-0.60-Debug.pdb,low,0
WinObjC,2804,1,4,modified,2,2,deps/prebuilt/Universal Windows/x86/cassowary-0.60.lib,low,0
WinObjC,2804,1,4,modified,2,2,deps/prebuilt/Universal Windows/x86/cassowary-0.60.pdb,low,0
WinObjC,2803,4,2,modified,1,1,samples/CoreAnimationTest/CoreAnimationTest.vsimporter/CoreAnimationTest-WinStore10/CoreAnimationTest.vcxproj,medium,0
WinObjC,2803,4,0,modified,0,0,samples/CoreAnimationTest/CoreAnimationTest.vsimporter/CoreAnimationTest-WinStore10/CoreAnimationTest_TemporaryKey.pfx,low,0
WinObjC,2803,4,2,modified,1,1,samples/GLKitComplex/GLKitComplex.vsimporter/GLKitComplex-WinStore10/GLKitComplex.vcxproj,medium,0
WinObjC,2803,4,0,modified,0,0,samples/GLKitComplex/GLKitComplex.vsimporter/GLKitComplex-WinStore10/GLKitComplex_TemporaryKey.pfx,low,0
WinObjC,2803,4,2,modified,1,1,samples/HelloGLKit/HelloGLKit.vsimporter/HelloGLKit-WinStore10/HelloGLKit.vcxproj,medium,0
WinObjC,2803,4,0,modified,0,0,samples/HelloGLKit/HelloGLKit.vsimporter/HelloGLKit-WinStore10/HelloGLKit_TemporaryKey.pfx,low,0
WinObjC,2803,4,2,modified,1,1,samples/HelloOpenGL/HelloOpenGL.vsimporter/HelloOpenGL-WinStore10/HelloOpenGL.vcxproj,medium,0
WinObjC,2803,4,0,modified,0,0,samples/HelloOpenGL/HelloOpenGL.vsimporter/HelloOpenGL-WinStore10/HelloOpenGL_TemporaryKey.pfx,low,0
WinObjC,2803,4,2,modified,1,1,samples/HelloUI/HelloUI.vsimporter/HelloUI-WinStore10/HelloUI.vcxproj,medium,0
WinObjC,2803,4,0,modified,0,0,samples/HelloUI/HelloUI.vsimporter/HelloUI-WinStore10/HelloUI_TemporaryKey.pfx,low,0
WinObjC,2803,4,0,modified,0,0,samples/KVOPerf/KVOPerf.vsimporter/KVOPerf-WinStore10/KVOPerf_TemporaryKey.pfx,low,0
WinObjC,2803,4,39,modified,9,30,samples/WOCCatalog/WOCCatalog.vsimporter/WOCCatalog-WinStore10/Package.appxmanifest,medium,0
WinObjC,2803,4,2,modified,1,1,samples/WOCCatalog/WOCCatalog.vsimporter/WOCCatalog-WinStore10/WOCCatalog.vcxproj,medium,0
WinObjC,2803,4,0,modified,0,0,samples/WOCCatalog/WOCCatalog.vsimporter/WOCCatalog-WinStore10/WOCCatalog_TemporaryKey.pfx,low,0
WinObjC,2803,4,0,modified,0,0,samples/WinRTSample/WinRTSample.vsimporter/WinRTSample-WinStore10/WinRTSample_TemporaryKey.pfx,low,0
WinObjC,2803,4,2,modified,1,1,samples/XAMLCatalog/XAMLCatalog.vsimporter/XAMLCatalog-WinStore10/XAMLCatalog.vcxproj,medium,0
WinObjC,2803,4,0,modified,0,0,samples/XAMLCatalog/XAMLCatalog.vsimporter/XAMLCatalog-WinStore10/XAMLCatalog_TemporaryKey.pfx,low,0
WinObjC,2803,4,2,modified,1,1,samples/XAMLTest/XamlTest.vsimporter/XamlTest-WinStore10/XamlTest.vcxproj,medium,0
WinObjC,2803,4,0,modified,0,0,samples/XAMLTest/XamlTest.vsimporter/XamlTest-WinStore10/XamlTest_TemporaryKey.pfx,low,0
WinObjC,2803,4,2,modified,1,1,tests/testapps/AddressBookSample/AddressBookSample.vsimporter/AddressBookSample-WinStore10/AddressBookSample.vcxproj,medium,0
WinObjC,2803,4,0,modified,0,0,tests/testapps/AddressBookSample/AddressBookSample.vsimporter/AddressBookSample-WinStore10/AddressBookSample_TemporaryKey.pfx,low,0
WinObjC,2803,4,39,modified,9,30,tests/testapps/AddressBookSample/AddressBookSample.vsimporter/AddressBookSample-WinStore10/Package.appxmanifest,medium,0
WinObjC,2803,4,2,modified,1,1,tests/testapps/ApplicationGroupFolderRead/ApplicationGroupFolderRead.vsimporter/ApplicationGroupFolderRead-WinStore10/ApplicationGroupFolderRead.vcxproj,medium,0
WinObjC,2803,4,0,modified,0,0,tests/testapps/ApplicationGroupFolderRead/ApplicationGroupFolderRead.vsimporter/ApplicationGroupFolderRead-WinStore10/ApplicationGroupFolderRead_TemporaryKey.pfx,low,0
WinObjC,2803,4,42,modified,10,32,tests/testapps/ApplicationGroupFolderRead/ApplicationGroupFolderRead.vsimporter/ApplicationGroupFolderRead-WinStore10/Package.appxmanifest,medium,0
WinObjC,2803,4,2,modified,1,1,tests/testapps/ApplicationGroupFolderWrite/ApplicationGroupFolderWrite.vsimporter/ApplicationGroupFolderWrite-WinStore10/ApplicationGroupFolderWrite.vcxproj,medium,0
WinObjC,2803,4,0,modified,0,0,tests/testapps/ApplicationGroupFolderWrite/ApplicationGroupFolderWrite.vsimporter/ApplicationGroupFolderWrite-WinStore10/ApplicationGroupFolderWrite_TemporaryKey.pfx,low,0
WinObjC,2803,4,45,modified,11,34,tests/testapps/ApplicationGroupFolderWrite/ApplicationGroupFolderWrite.vsimporter/ApplicationGroupFolderWrite-WinStore10/Package.appxmanifest,medium,0
WinObjC,2803,4,2,modified,1,1,tests/testapps/CGCatalog/CGCatalog.vsimporter/CGCatalog-WinStore10/CGCatalog.vcxproj,medium,0
WinObjC,2803,4,0,modified,0,0,tests/testapps/CGCatalog/CGCatalog.vsimporter/CGCatalog-WinStore10/CGCatalog_TemporaryKey.pfx,low,0
WinObjC,2799,1,10,modified,10,0,common/winobjc.nuproj.common.props,medium,0
WinObjC,2799,1,20,modified,20,0,common/winobjc.nuproj.common.targets,low,0
WinObjC,2799,1,4,modified,2,2,deps/prebuilt/Universal Windows/ARM/cassowary-0.60-Debug.lib,low,0
WinObjC,2799,1,4,modified,2,2,deps/prebuilt/Universal Windows/ARM/cassowary-0.60-Debug.pdb,low,0
WinObjC,2799,1,4,modified,2,2,deps/prebuilt/Universal Windows/ARM/cassowary-0.60.lib,low,0
WinObjC,2799,1,4,modified,2,2,deps/prebuilt/Universal Windows/ARM/cassowary-0.60.pdb,low,0
WinObjC,2799,1,4,modified,2,2,deps/prebuilt/Universal Windows/x86/cassowary-0.60-Debug.lib,low,0
WinObjC,2799,1,4,modified,2,2,deps/prebuilt/Universal Windows/x86/cassowary-0.60-Debug.pdb,low,0
WinObjC,2799,1,4,modified,2,2,deps/prebuilt/Universal Windows/x86/cassowary-0.60.lib,low,0
WinObjC,2799,1,4,modified,2,2,deps/prebuilt/Universal Windows/x86/cassowary-0.60.pdb,low,0
WinObjC,2799,1,2,modified,1,1,msvc/package-build.props,medium,0
WinObjC,2799,1,2,modified,1,1,msvc/sdk-build.props,medium,0
WinObjC,2799,1,4,modified,3,1,tools/AppInsights/Projects/AppInsights_Win10-UAP/AppInsights_Win10-UAP/AppInsights_Win10-UAP.vcxproj,medium,0
WinObjC,2799,1,6,modified,3,3,tools/AppInsights/Projects/AppInsights_Win10-UAP/AppInsights_Win10-UAP/AppInsights_Win10-UAP.vcxproj.filters,medium,0
WinObjC,2799,1,2,modified,1,1,tools/AppInsights/Projects/AppInsights_Win10-UAP/AppInsights_Win10-UAP/Project.json,medium,0
WinObjC,2799,1,4,modified,3,1,tools/AppInsights/Projects/AppInsights_Win10-UAP/ApplicationInsights/ApplicationInsights.vcxproj,medium,0
WinObjC,2799,1,3,modified,3,0,tools/AppInsights/Projects/AppInsights_Win10-UAP/ApplicationInsights/ApplicationInsights.vcxproj.filters,medium,0
WinObjC,2799,1,2,modified,1,1,tools/AppInsights/Projects/AppInsights_Win10-UAP/ApplicationInsights/Project.json,medium,0
WinObjC,2799,1,10,modified,5,5,tools/AppInsights/Projects/AppInsights_Win32/core/core.vcxproj,medium,0
WinObjC,2799,1,4,modified,2,2,tools/AppInsights/Projects/AppInsights_Win32/core/packages.config,medium,0
WinObjC,2799,1,4,modified,2,2,tools/AssetCatalogBuilder/Project.json,medium,0
WinObjC,2799,1,6,modified,3,3,tools/BuildMonitor/BuildMonitor.csproj,low,0
WinObjC,2799,1,4,modified,2,2,tools/BuildMonitor/packages.config,medium,0
WinObjC,2799,1,4,modified,2,2,tools/ClangCompileTask/Project.json,medium,0
WinObjC,2799,1,4,modified,3,1,tools/Logging/dll/Logging.vcxproj,medium,0
WinObjC,2799,1,4,modified,2,2,tools/Logging/dll/Project.json,medium,0
WinObjC,2799,1,2,modified,2,0,tools/Logging/lib/LoggingLib.vcxproj,medium,0
WinObjC,2799,1,4,modified,2,2,tools/PropSchemaGen/Project.json,medium,0
WinObjC,2799,1,8,modified,4,4,tools/VSIX/ObjectiveCVSIX.csproj,low,0
WinObjC,2799,1,4,modified,2,2,tools/VSIX/packages.config,medium,0
WinObjC,2797,1,12,modified,6,6,README.md,low,0
WinObjC,2795,1,2,modified,1,1,msvc/sdk-build.props,medium,0
WinObjC,2795,1,2,modified,1,1,msvc/ut-build.props,medium,0
WinObjC,2793,1,6,modified,6,0,tests/functionaltests/Tests/NSURLConnectionTests.mm,medium,0
WinObjC,2793,1,21,modified,6,15,tests/functionaltests/Tests/NSURLSession.mm,medium,0
WinObjC,2788,1,2,modified,1,1,Frameworks/UIKit.Xaml/TextField.xaml.cpp,high,0
WinObjC,2786,1,1,modified,1,0,tools/WinObjC.Tools/Readme.txt,low,0
WinObjC,2786,1,5,modified,3,2,tools/WinObjC.Tools/WinObjC.Tools.nuproj,medium,0
WinObjC,2786,1,617,added,617,0,tools/objc2winmd/ClangHelpers.cpp,high,0
WinObjC,2786,1,102,added,102,0,tools/objc2winmd/ClangHelpers.h,high,0
WinObjC,2786,1,1340,added,1340,0,tools/objc2winmd/ClangObjectModel.cpp,high,0
WinObjC,2786,1,525,added,525,0,tools/objc2winmd/ClangObjectModel.h,high,0
WinObjC,2786,1,364,added,364,0,tools/objc2winmd/CommonCodeGenerator.cpp,high,0
WinObjC,2786,1,28,added,28,0,tools/objc2winmd/CommonCodeGenerator.h,high,0
WinObjC,2786,1,883,added,883,0,tools/objc2winmd/ContainerTemplates.cpp,high,0
WinObjC,2786,1,68,added,68,0,tools/objc2winmd/ContainerTemplates.h,high,0
WinObjC,2786,1,252,added,252,0,tools/objc2winmd/Helpers.cpp,high,0
WinObjC,2786,1,79,added,79,0,tools/objc2winmd/Helpers.h,high,0
WinObjC,2786,1,147,added,147,0,tools/objc2winmd/Readme.txt,low,0
WinObjC,2786,1,643,added,643,0,tools/objc2winmd/TypeConvertor.cpp,high,0
WinObjC,2786,1,197,added,197,0,tools/objc2winmd/TypeConvertor.h,high,0
WinObjC,2786,1,2888,added,2888,0,tools/objc2winmd/objc2winmd.cpp,high,0
WinObjC,2786,1,238,added,238,0,tools/objc2winmd/objc2winmd.vcxproj,medium,0
WinObjC,2786,1,102,added,102,0,tools/objc2winmd/objc2winmd.vcxproj.filters,medium,0
WinObjC,2786,1,4,added,4,0,tools/objc2winmd/packages.config,medium,0
WinObjC,2786,1,24,added,24,0,tools/objc2winmd/stdafx.cpp,high,0
WinObjC,2786,1,50,added,50,0,tools/objc2winmd/stdafx.h,high,0
WinObjC,2786,1,24,added,24,0,tools/objc2winmd/targetver.h,high,0
WinObjC,2786,1,264,added,264,0,tools/objc2winmd/tokenizer.cpp,high,0
WinObjC,2786,1,74,added,74,0,tools/objc2winmd/tokenizer.h,high,0
WinObjC,2786,1,23,modified,22,1,tools/tools.sln,low,0
WinObjC,2784,2,2,modified,2,0,tests/functionaltests/Tests/UIKitTests/UIActionSheetTests.mm,medium,0
WinObjC,2778,2,16,modified,12,4,Frameworks/Foundation/NSArray.mm,medium,0
WinObjC,2773,1,12,modified,1,11,Frameworks/Foundation/NSArray.mm,medium,0
WinObjC,2773,1,12,modified,10,2,Frameworks/Foundation/NSCFArray.mm,medium,0
WinObjC,2773,1,12,modified,12,0,Frameworks/Foundation/NSCFCollectionSupport.h,high,0
WinObjC,2773,1,71,modified,34,37,Frameworks/Foundation/NSMutableArray.mm,medium,0
WinObjC,2773,1,2,modified,1,1,include/Foundation/NSMutableArray.h,high,0
WinObjC,2773,1,88,modified,88,0,tests/unittests/Foundation/NSArrayTests.mm,medium,0
WinObjC,2767,1,11,modified,9,2,tests/functionaltests/Tests/UIKitTests/UIButtonTests.mm,medium,0
WinObjC,2766,1,2,modified,2,0,build/nuget.config,medium,0
WinObjC,2765,2,2,modified,1,1,Frameworks/Foundation/NSURLProtocol.mm,medium,0
WinObjC,2765,2,5,modified,5,0,Frameworks/Foundation/NSURLProtocolInternal.h,high,0
WinObjC,2765,2,3,modified,2,1,Frameworks/Foundation/NSURLProtocol_WinHTTP.mm,medium,0
WinObjC,2765,2,24,removed,0,24,Frameworks/include/NSURLProtocolInternal.h,high,0
WinObjC,2765,2,52,modified,52,0,tests/functionaltests/Tests/NSURLSession.mm,medium,0
WinObjC,2763,1,20,modified,13,7,tests/unittests/Foundation/NSFileManagerTests.mm,medium,0
WinObjC,2761,2,7,modified,7,0,Frameworks/Foundation/NSURL.mm,medium,0
WinObjC,2761,2,1,modified,1,0,tests/frameworks/include/Helpers/TestHelpers.h,high,0
WinObjC,2761,2,467,modified,270,197,tests/functionaltests/Tests/NSURLSession.mm,medium,0
WinObjC,2761,2,7,modified,7,0,tests/helpers/THBooleanCondition.mm,medium,0
WinObjC,2760,3,1,modified,1,0,build/Tests/Tests.Shared/Tests.Shared.vcxitems,NaN,0
WinObjC,2760,3,7,modified,4,3,build/WinObjC.Frameworks.Core/WinObjC.Frameworks.Core.targets,low,0
WinObjC,2757,1,2,modified,2,0,tests/functionaltests/Tests/NSURLConnectionTests.mm,medium,0
WinObjC,2755,2,2,modified,2,0,Frameworks/Foundation/NSURLConnection.mm,medium,0
WinObjC,2755,2,17,modified,11,6,Frameworks/Foundation/NSURLSession.mm,medium,0
WinObjC,2753,7,79,modified,38,41,Frameworks/CoreGraphics/CGPath.mm,medium,0
WinObjC,2753,7,281,modified,112,169,Frameworks/UIKit/UIBezierPath.mm,medium,0
WinObjC,2753,7,6,modified,5,1,build/Tests/UnitTests/CoreGraphics.Drawing/CoreGraphics.Drawing.UnitTests.vcxproj,medium,0
WinObjC,2753,7,3,modified,2,1,build/Tests/UnitTests/UIKit/UIKit.UnitTests.vcxproj,medium,0
WinObjC,2753,7,14,modified,7,7,include/UIKit/UIBezierPath.h,high,0
WinObjC,2753,7,384,added,384,0,tests/unittests/CoreGraphics.drawing/UIBezierPath_DrawingTest.mm,medium,0
WinObjC,2753,7,3,added,3,0,tests/unittests/CoreGraphics.drawing/data/reference/TestImage.UIBezierPath.AddCurveToPoint.png,low,0
WinObjC,2753,7,3,added,3,0,tests/unittests/CoreGraphics.drawing/data/reference/TestImage.UIBezierPath.AddLineToPoint.png,low,0
WinObjC,2753,7,3,added,3,0,tests/unittests/CoreGraphics.drawing/data/reference/TestImage.UIBezierPath.AddPath.png,low,0
WinObjC,2753,7,3,added,3,0,tests/unittests/CoreGraphics.drawing/data/reference/TestImage.UIBezierPath.AddQuadCurveToPoint.png,low,0
WinObjC,2753,7,3,added,3,0,tests/unittests/CoreGraphics.drawing/data/reference/TestImage.UIBezierPath.BlendModeBezier.png,low,0
WinObjC,2753,7,3,added,3,0,tests/unittests/CoreGraphics.drawing/data/reference/TestImage.UIBezierPath.CloseSubpath.png,low,0
WinObjC,2753,7,3,added,3,0,tests/unittests/CoreGraphics.drawing/data/reference/TestImage.UIBezierPath.FillArcsComplex.png,low,0
WinObjC,2753,7,3,added,3,0,tests/unittests/CoreGraphics.drawing/data/reference/TestImage.UIBezierPath.FillArcsSimple.png,low,0
WinObjC,2753,7,3,added,3,0,tests/unittests/CoreGraphics.drawing/data/reference/TestImage.UIBezierPath.FillStraightLines.png,low,0
WinObjC,2753,7,3,added,3,0,tests/unittests/CoreGraphics.drawing/data/reference/TestImage.UIBezierPath.LineDash.png,low,0
WinObjC,2753,7,3,added,3,0,tests/unittests/CoreGraphics.drawing/data/reference/TestImage.UIBezierPath.Rectangle.png,low,0
WinObjC,2753,7,3,added,3,0,tests/unittests/CoreGraphics.drawing/data/reference/TestImage.UIBezierPath.RoundedRect.png,low,0
WinObjC,2753,7,83,added,83,0,tests/unittests/UIKit/UIBezierPathTests.mm,medium,0
WinObjC,2752,1,12,modified,11,1,Frameworks/Foundation/NSOperationQueue.mm,medium,0
WinObjC,2750,1,3,modified,3,0,tests/helpers/THRunLoopSpinner.mm,medium,0
WinObjC,2750,1,20,modified,13,7,tests/unittests/Foundation/NSNotificationQueueTests.mm,medium,0
WinObjC,2747,1,46,added,46,0,RTObjCInterop/RTObjCInterop.sln,low,0
WinObjC,2747,1,218,added,218,0,RTObjCInterop/RTObjCInterop/RTObjCInterop.vcxproj,medium,0
WinObjC,2747,1,38,added,38,0,RTObjCInterop/RTObjCInterop/RTObjCInterop.vcxproj.filters,medium,0
WinObjC,2747,1,27,added,27,0,RTObjCInterop/RTObjCInterop/dllmain.cpp,high,0
WinObjC,2747,1,52,added,52,0,RTObjCInterop/RTObjCInterop/export.def,low,0
WinObjC,2747,1,81,added,81,0,RTObjCInterop/RTObjCInterop/src/InteropBase.mm,medium,0
WinObjC,2747,1,495,added,495,0,RTObjCInterop/RTObjCInterop/src/ObjCHelpers.mm,medium,0
WinObjC,2747,1,631,added,631,0,RTObjCInterop/RTObjCInterop/src/RTHelpers.mm,medium,0
WinObjC,2747,1,55,added,55,0,RTObjCInterop/RTObjCInterop/src/RTObject.mm,medium,0
WinObjC,2747,1,0,renamed,0,0,RTObjCInterop/WinObjC.Frameworks.UWP.Core/Readme.txt,low,0
WinObjC,2747,1,18,added,18,0,RTObjCInterop/WinObjC.Frameworks.UWP.Core/WinObjC.Frameworks.UWP.Core.Packageable.props,medium,0
WinObjC,2747,1,26,added,26,0,RTObjCInterop/WinObjC.Frameworks.UWP.Core/WinObjC.Frameworks.UWP.Core.Packageable.targets,low,0
WinObjC,2747,1,22,added,22,0,RTObjCInterop/WinObjC.Frameworks.UWP.Core/WinObjC.Frameworks.UWP.Core.Packaging.props,medium,0
WinObjC,2747,1,3,added,3,0,RTObjCInterop/WinObjC.Frameworks.UWP.Core/WinObjC.Frameworks.UWP.Core.Packaging.targets,low,0
WinObjC,2747,1,29,renamed,12,17,RTObjCInterop/WinObjC.Frameworks.UWP.Core/WinObjC.Frameworks.UWP.Core.nuproj,medium,0
WinObjC,2747,1,22,removed,0,22,build/WinObjC.Frameworks.UWP.Core/WinObjC.Frameworks.UWP.Core.Packaging.props,medium,0
WinObjC,2747,1,35,removed,0,35,build/WinObjC.Frameworks.UWP.Core/WinObjC.Frameworks.UWP.Core.Packaging.targets,low,0
WinObjC,2747,1,3,removed,0,3,build/WinObjC.Frameworks.UWP.Core/WinObjC.Frameworks.UWP.Core.props,medium,0
WinObjC,2747,1,41,removed,0,41,build/WinObjC.Frameworks.UWP.Core/WinObjC.Frameworks.UWP.Core.targets,low,0
WinObjC,2747,1,15,modified,0,15,build/build.sln,low,0
WinObjC,2744,2,3,modified,3,0,build/Tests/FunctionalTests/FunctionalTests.vcxproj,medium,0
WinObjC,2744,2,180,added,180,0,build/Tests/Tests.Helpers/Tests.Helpers.vcxproj,medium,0
WinObjC,2744,2,3,modified,3,0,build/Tests/UnitTests/Foundation/Foundation.UnitTests.vcxproj,medium,0
WinObjC,2744,2,13,modified,13,0,build/build.sln,low,0
WinObjC,2744,2,34,added,34,0,tests/frameworks/include/Helpers/TestHelpers.h,high,0
WinObjC,2744,2,94,modified,17,77,tests/functionaltests/Tests/NSURLConnectionTests.mm,medium,0
WinObjC,2744,2,49,added,49,0,tests/helpers/THBooleanCondition.mm,medium,0
WinObjC,2744,2,102,added,102,0,tests/helpers/THRunLoopSpinner.mm,medium,0
WinObjC,2744,2,65,modified,12,53,tests/unittests/Foundation/NSOperationTests.mm,medium,0
WinObjC,2744,2,8,modified,8,0,tests/unittests/UT.common.mk,NaN,0
WinObjC,2740,1,1,modified,0,1,include/CoreGraphics/CGGeometry.h,high,0
WinObjC,2735,4,8,modified,3,5,Frameworks/Foundation/NSDictionary+NSFileManagerExtensions.mm,medium,0
WinObjC,2735,4,6,modified,2,4,Frameworks/Foundation/NSDirectoryEnumerator.mm,medium,0
WinObjC,2735,4,472,modified,320,152,Frameworks/Foundation/NSFileManager.mm,medium,0
WinObjC,2735,4,101,modified,57,44,include/Foundation/NSFileManager.h,high,0
WinObjC,2735,4,161,modified,124,37,tests/unittests/Foundation/NSFileManagerTests.mm,medium,0
WinObjC,2734,1,9,modified,9,0,tests/functionaltests/Tests/NSURLConnectionTests.mm,medium,0
WinObjC,2733,17,1,modified,1,0,build/CFNetwork/lib/CFNetworkLib.vcxproj,medium,0
WinObjC,2733,17,1,modified,1,0,build/CoreFoundation/lib/CoreFoundationLib.vcxproj,medium,0
WinObjC,2733,17,1,modified,1,0,build/CoreFoundationAdditions/lib/CoreFoundationAdditionsLib.vcxproj,medium,0
WinObjC,2733,17,1,modified,1,0,build/Foundation/lib/FoundationLib.vcxproj,medium,0
WinObjC,2733,17,1,modified,1,0,build/MobileCoreServices/lib/MobileCoreServicesLib.vcxproj,medium,0
WinObjC,2733,17,1,modified,1,0,build/Starboard/lib/StarboardLib.vcxproj,medium,0
WinObjC,2733,17,3,modified,3,0,build/Tests/FunctionalTests/FunctionalTests.vcxproj,medium,0
WinObjC,2733,17,3,modified,3,0,build/Tests/UnitTests/AddressBook/AddressBook.UnitTests.vcxproj,medium,0
WinObjC,2733,17,3,modified,3,0,build/Tests/UnitTests/Starboard/Starboard.UnitTests.vcxproj,medium,0
WinObjC,2733,17,5,removed,0,5,build/WinObjC.Frameworks.UWP/Readme.txt,low,0
WinObjC,2733,17,22,removed,0,22,build/WinObjC.Frameworks.UWP/WinObjC.Frameworks.UWP.Packaging.props,medium,0
WinObjC,2733,17,32,removed,0,32,build/WinObjC.Frameworks.UWP/WinObjC.Frameworks.UWP.Packaging.targets,low,0
WinObjC,2733,17,68,removed,0,68,build/WinObjC.Frameworks.UWP/WinObjC.Frameworks.UWP.nuproj,medium,0
WinObjC,2733,17,3,removed,0,3,build/WinObjC.Frameworks.UWP/WinObjC.Frameworks.UWP.props,medium,0
WinObjC,2733,17,40,removed,0,40,build/WinObjC.Frameworks.UWP/WinObjC.Frameworks.UWP.targets,low,0
WinObjC,2733,17,3,modified,0,3,build/WinObjC.Frameworks/WinObjC.Frameworks.nuproj,medium,0
WinObjC,2733,17,3,modified,0,3,build/build.sln,low,0
WinObjC,2733,17,2,modified,2,0,build/nuget.config,medium,0
WinObjC,2733,17,3,removed,0,3,deps/prebuilt/Universal Windows/ARM/ObjCUWPMicrosoftAdvertising.dll,high,0
WinObjC,2733,17,3,removed,0,3,deps/prebuilt/Universal Windows/ARM/ObjCUWPMicrosoftAdvertising.lib,low,0
WinObjC,2733,17,3,removed,0,3,deps/prebuilt/Universal Windows/ARM/ObjCUWPWindowsApplicationModelAppExtensions.dll,high,0
WinObjC,2733,17,3,removed,0,3,deps/prebuilt/Universal Windows/ARM/ObjCUWPWindowsApplicationModelAppExtensions.lib,low,0
WinObjC,2733,17,3,removed,0,3,deps/prebuilt/Universal Windows/ARM/ObjCUWPWindowsApplicationModelAppService.dll,high,0
WinObjC,2733,17,3,removed,0,3,deps/prebuilt/Universal Windows/ARM/ObjCUWPWindowsApplicationModelAppService.lib,low,0
WinObjC,2733,17,3,removed,0,3,deps/prebuilt/Universal Windows/ARM/ObjCUWPWindowsApplicationModelAppointmentsDataProvider.dll,high,0
WinObjC,2733,17,3,removed,0,3,deps/prebuilt/Universal Windows/ARM/ObjCUWPWindowsApplicationModelAppointmentsDataProvider.lib,low,0
WinObjC,2733,17,3,removed,0,3,deps/prebuilt/Universal Windows/ARM/ObjCUWPWindowsApplicationModelCallsBackground.dll,high,0
WinObjC,2733,17,3,removed,0,3,deps/prebuilt/Universal Windows/ARM/ObjCUWPWindowsApplicationModelCallsBackground.lib,low,0
WinObjC,2733,17,3,removed,0,3,deps/prebuilt/Universal Windows/ARM/ObjCUWPWindowsApplicationModelCallsProvider.dll,high,0
WinObjC,2733,17,3,removed,0,3,deps/prebuilt/Universal Windows/ARM/ObjCUWPWindowsApplicationModelCallsProvider.lib,low,0
WinObjC,2732,1,2,modified,1,1,tools/winmd2objc/lib/CodeGen.cpp,high,0
WinObjC,2731,2,4,modified,4,0,Frameworks/Foundation/NSNotification.mm,medium,0
WinObjC,2731,2,85,modified,63,22,Frameworks/Foundation/NSNotificationQueue.mm,medium,0
WinObjC,2731,2,8,modified,1,7,Frameworks/Foundation/NSRunLoop.mm,medium,0
WinObjC,2731,2,1,modified,1,0,build/Tests/UnitTests/Foundation/Foundation.UnitTests.vcxproj,medium,0
WinObjC,2731,2,1,modified,1,0,build/Tests/UnitTests/Foundation/Foundation.UnitTests.vcxproj.filters,medium,0
WinObjC,2731,2,28,modified,18,10,include/Foundation/NSNotificationQueue.h,high,0
WinObjC,2731,2,156,added,156,0,tests/unittests/Foundation/NSNotificationQueueTests.mm,medium,0
WinObjC,2729,2,2,modified,0,2,tools/winmd2objc/include/CodeGen.h,high,0
WinObjC,2729,2,75,modified,1,74,tools/winmd2objc/lib/CodeGen.cpp,high,0
WinObjC,2729,2,2,modified,0,2,tools/winmd2objc/lib/main.cpp,high,0
WinObjC,2727,4,35,modified,19,16,Frameworks/Foundation/NSURLProtocol.mm,medium,0
WinObjC,2727,4,76,modified,76,0,Frameworks/Foundation/NSURLRequest.mm,medium,0
WinObjC,2727,4,11,modified,3,8,Frameworks/Foundation/NSURLSessionTask.mm,medium,0
WinObjC,2727,4,5,modified,5,0,Frameworks/include/NSURLRequestInternal.h,high,0
WinObjC,2727,4,1,modified,1,0,build/Tests/UnitTests/Foundation/Foundation.UnitTests.vcxproj,medium,0
WinObjC,2727,4,1,modified,1,0,build/Tests/UnitTests/Foundation/Foundation.UnitTests.vcxproj.filters,medium,0
WinObjC,2727,4,6,modified,3,3,include/Foundation/NSURLProtocol.h,high,0
WinObjC,2727,4,24,modified,12,12,include/Foundation/NSURLSession.h,high,0
WinObjC,2727,4,47,added,47,0,tests/unittests/Foundation/NSURLProtocolTests.mm,medium,0
WinObjC,2726,1,5,modified,4,1,tests/unittests/Foundation/NSDateFormatterTests.m,high,0
WinObjC,2726,1,7,modified,6,1,tests/unittests/Foundation/ReferenceFoundation/TestNSDateFormatter.mm,medium,0
WinObjC,2724,2,103,modified,61,42,Frameworks/Foundation/NSURLConnection.mm,medium,0
WinObjC,2724,2,2,modified,1,1,build/Tests/FunctionalTests/FunctionalTests.vcxproj,medium,0
WinObjC,2724,2,2,modified,1,1,build/Tests/FunctionalTests/FunctionalTests.vcxproj.filters,medium,0
WinObjC,2724,2,174,renamed,160,14,tests/functionaltests/Tests/NSURLConnectionTests.mm,medium,0
WinObjC,2723,2,26,modified,19,7,Frameworks/UIKit/UIAlertView.mm,medium,0
WinObjC,2723,2,5,modified,3,2,Frameworks/UIKit/UILabel.mm,medium,0
WinObjC,2722,1,5,modified,2,3,tools/winmd2objc/lib/CodeGen.cpp,high,0
WinObjC,2720,2,24,modified,23,1,Frameworks/Foundation/NSURLConnection.mm,medium,0
WinObjC,2720,2,26,added,26,0,Frameworks/Foundation/NSURLProtocolInternal.h,high,0
WinObjC,2720,2,64,modified,48,16,Frameworks/Foundation/NSURLProtocol_WinHTTP.mm,medium,0
WinObjC,2720,2,2,modified,1,1,include/Foundation/NSURLConnection.h,high,0
WinObjC,2720,2,278,modified,219,59,tests/functionaltests/Tests/NSURLConnection.mm,medium,0
WinObjC,2716,2,2,modified,1,1,include/UIKit/UIPasteboard.h,high,0
WinObjC,2716,2,3,modified,2,1,include/UIKit/UIPickerViewDelegate.h,high,0
WinObjC,2716,2,3,modified,2,1,include/UIKit/UIPopoverPresentationControllerDelegate.h,high,0
WinObjC,2716,2,3,modified,2,1,include/UIKit/UIPress.h,high,0
WinObjC,2716,2,3,modified,2,1,include/UIKit/UIPrintInteractionControllerDelegate.h,high,0
WinObjC,2716,2,2,modified,1,1,include/UIKit/UITableViewCell.h,high,0
WinObjC,2716,2,2,modified,1,1,include/UIKit/UIView.h,high,0
WinObjC,2714,2,15,modified,13,2,Frameworks/Foundation/NSException.cl.cpp,high,0
WinObjC,2714,2,20,modified,8,12,Frameworks/Foundation/NSException.mm,medium,0
WinObjC,2714,2,14,modified,14,0,Frameworks/include/CppWinRTHelpers.h,high,0
WinObjC,2712,3,86,modified,0,86,Frameworks/Foundation/NSCoder.mm,medium,0
WinObjC,2712,3,1,modified,1,0,Frameworks/UIKit/UIScreen.mm,medium,0
WinObjC,2712,3,2,modified,0,2,include/Foundation/Foundation.h,high,0
WinObjC,2712,3,53,removed,0,53,include/Foundation/NSAffineTransform.h,high,0
WinObjC,2712,3,174,removed,0,174,include/Foundation/NSGeometry.h,high,0
WinObjC,2712,3,1,modified,1,0,include/UIKit/UIAccessibility.h,high,0
WinObjC,2712,3,4,modified,3,1,include/UIKit/UIApplication.h,high,0
WinObjC,2712,3,7,modified,4,3,include/UIKit/UIApplicationDelegate.h,high,0
WinObjC,2712,3,16,modified,8,8,include/UIKit/UIGestureRecognizer.h,high,0
WinObjC,2712,3,1,modified,1,0,include/UIKit/UIMenuController.h,high,0
WinObjC,2712,3,1,modified,1,0,include/UIKit/UIPanGestureRecognizer.h,high,0
WinObjC,2712,3,1,modified,1,0,include/UIKit/UIScreenMode.h,high,0
WinObjC,2712,3,1,modified,1,0,include/UIKit/UITextInput.h,high,0
WinObjC,2710,3,80,modified,45,35,Frameworks/UIKit/UIWebView.mm,medium,0
WinObjC,2708,3,6,modified,5,1,tools/WinObjC.Tools/Readme.txt,low,0
WinObjC,2708,3,5,modified,3,2,tools/WinObjC.Tools/WinObjC.Tools.nuproj,medium,0
WinObjC,2708,3,126,modified,126,0,tools/tools.sln,low,0
WinObjC,2708,3,9,added,9,0,tools/winmd2objc/Common/WinObjC.Frameworks.UWP.Common.targets,low,0
WinObjC,2708,3,79,added,79,0,tools/winmd2objc/UnitTests/CodeGenTests.cpp,high,0
WinObjC,2708,3,24,added,24,0,tools/winmd2objc/UnitTests/TestFramework.cpp,high,0
WinObjC,2708,3,28,added,28,0,tools/winmd2objc/UnitTests/TypeInfoTests.cpp,high,0
WinObjC,2708,3,179,added,179,0,tools/winmd2objc/UnitTests/UnitTests.vcxproj,medium,0
WinObjC,2708,3,28,added,28,0,tools/winmd2objc/UnitTests/UnitTests.vcxproj.filters,medium,0
WinObjC,2708,3,24,added,24,0,tools/winmd2objc/UnitTests/stdafx.cpp,high,0
WinObjC,2708,3,27,added,27,0,tools/winmd2objc/UnitTests/stdafx.h,high,0
WinObjC,2708,3,92,added,92,0,tools/winmd2objc/include/CodeGen.h,high,0
WinObjC,2708,3,167,added,167,0,tools/winmd2objc/include/CodeGenModel.h,high,0
WinObjC,2708,3,31,added,31,0,tools/winmd2objc/include/CommandLine.h,high,0
WinObjC,2708,3,19,added,19,0,tools/winmd2objc/include/Conversion.h,high,0
WinObjC,2708,3,40,added,40,0,tools/winmd2objc/include/DepResolution.h,high,0
WinObjC,2708,3,75,added,75,0,tools/winmd2objc/include/Generics.h,high,0
WinObjC,2708,3,786,added,786,0,tools/winmd2objc/include/MetadataScope.h,high,0
WinObjC,2708,3,80,added,80,0,tools/winmd2objc/include/Misc.h,high,0
WinObjC,2708,3,851,added,851,0,tools/winmd2objc/include/ObjectModel.h,high,0
WinObjC,2708,3,47,added,47,0,tools/winmd2objc/include/ShimTracker.h,high,0
WinObjC,2708,3,385,added,385,0,tools/winmd2objc/include/TypeEnumerator.h,high,0
WinObjC,2708,3,56,added,56,0,tools/winmd2objc/include/TypeInfo.h,high,0
WinObjC,2708,3,43,added,43,0,tools/winmd2objc/include/WinMDVerString.h,high,0
WinObjC,2708,3,253,added,253,0,tools/winmd2objc/include/WinRTSymbolTable.h,high,0
WinObjC,2708,3,227,added,227,0,tools/winmd2objc/include/WinrtType.h,high,0
WinObjC,2708,3,315,added,315,0,tools/winmd2objc/include/caparser.h,high,0
WinObjC,2708,3,2885,added,2885,0,tools/winmd2objc/lib/CodeGen.cpp,high,0
WinObjC,2708,3,126,added,126,0,tools/winmd2objc/lib/CommandLine.cpp,high,0
WinObjC,2708,3,111,added,111,0,tools/winmd2objc/lib/DepResolution.cpp,high,0
WinObjC,2707,2,4,modified,0,4,Frameworks/CoreFoundation/Preferences.subproj/CFPreferences.c,high,0
WinObjC,2706,3,41,modified,30,11,Frameworks/UIKit.Xaml/TextField.xaml.cpp,high,0
WinObjC,2706,3,3,modified,2,1,Frameworks/UIKit.Xaml/TextField.xaml.h,high,0
WinObjC,2706,3,3,modified,3,0,Frameworks/UIKit/UISlider.mm,medium,0
WinObjC,2706,3,17,modified,15,2,Frameworks/UIKit/UITextField.mm,medium,0
WinObjC,2706,3,1,modified,1,0,build/Tests/FunctionalTests/FunctionalTests.vcxproj,medium,0
WinObjC,2706,3,6,modified,3,3,include/UIKit/UITextField.h,high,0
WinObjC,2706,3,2,modified,2,0,samples/XAMLCatalog/XAMLCatalog.vsimporter/XAMLCatalog-WinStore10/XAMLCatalog.vcxproj,medium,0
WinObjC,2706,3,6,modified,6,0,samples/XAMLCatalog/XAMLCatalog.vsimporter/XAMLCatalog-WinStore10/XAMLCatalog.vcxproj.filters,medium,0
WinObjC,2706,3,6,modified,6,0,samples/XAMLCatalog/XAMLCatalog.xcodeproj/project.pbxproj,high,0
WinObjC,2706,3,4,modified,4,0,samples/XAMLCatalog/XAMLCatalog/ProgrammaticViewController.m,high,0
WinObjC,2706,3,78,added,78,0,samples/XAMLCatalog/XAMLCatalog/UIKitControls/UITextFieldViewController2.h,high,0
WinObjC,2706,3,282,added,282,0,samples/XAMLCatalog/XAMLCatalog/UIKitControls/UITextFieldViewController2.m,high,0
WinObjC,2706,3,30,modified,6,24,tests/functionaltests/Tests/UIKitTests/UILabelTests.mm,medium,0
WinObjC,2706,3,411,modified,398,13,tests/functionaltests/Tests/UIKitTests/UITextFieldTests.mm,medium,0
WinObjC,2706,3,4,modified,3,1,tests/functionaltests/UXTestHelpers.h,high,0
WinObjC,2706,3,12,modified,8,4,tests/functionaltests/UXTestHelpers.mm,medium,0
WinObjC,2699,1,14,modified,9,5,Frameworks/Foundation/NSScanner.mm,medium,0
WinObjC,2697,4,1,modified,0,1,Frameworks/Foundation/NSBlocks.mm,medium,0
WinObjC,2697,4,219,modified,128,91,Frameworks/Foundation/NSURLConnection.mm,medium,0
WinObjC,2697,4,8,modified,0,8,Frameworks/Foundation/NSURLProtocol.mm,medium,0
WinObjC,2697,4,54,modified,36,18,Frameworks/Foundation/NSURLProtocol_WinHTTP.mm,medium,0
WinObjC,2697,4,2,modified,0,2,Frameworks/Foundation/NSURLProtocol_file.h,high,0
WinObjC,2697,4,9,modified,0,9,Frameworks/Foundation/NSURLProtocol_file.mm,medium,0
WinObjC,2697,4,38,modified,35,3,tests/functionaltests/Tests/NSURLConnection.mm,medium,0
WinObjC,2697,4,1,modified,0,1,tests/functionaltests/Tests/NSURLSession.mm,medium,0
WinObjC,2693,12,320,modified,217,103,Frameworks/Foundation/NSKVOSupport.mm,medium,0
WinObjC,2693,12,147,modified,84,63,Frameworks/Foundation/NSKVOSwizzling.mm,medium,0
WinObjC,2693,12,18,modified,14,4,Frameworks/Foundation/NSObject_NSKeyValueSetAdapter.mm,medium,0
WinObjC,2693,12,4,modified,2,2,Frameworks/include/NSKeyValueObserving-Internal.h,high,0
WinObjC,2693,12,6,modified,3,3,include/Foundation/NSKeyValueObserving.h,high,0
WinObjC,2693,12,34,modified,34,0,tests/UnitTests/Foundation/FoundationTests.mm,medium,0
WinObjC,2693,12,263,modified,259,4,tests/unittests/Foundation/NSObject_KeyValueObservationTests.mm,medium,0
WinObjC,2691,6,1,modified,1,0,build/Tests/UnitTests/CoreGraphics.Drawing/CoreGraphics.Drawing.UnitTests.vcxproj,medium,0
WinObjC,2691,6,35,modified,34,1,tests/UnitTests/CoreGraphics.drawing/CGContextDrawingTests.cpp,high,0
WinObjC,2691,6,196,added,196,0,tests/unittests/CoreGraphics.drawing/CGContextDrawing_DrawingOptionsTests.cpp,high,0
WinObjC,2691,6,3,added,3,0,tests/unittests/CoreGraphics.drawing/data/reference/TestImage.CGContext.StrokeRectWithWidth.png,low,0
WinObjC,2691,6,3,added,3,0,tests/unittests/CoreGraphics.drawing/data/reference/TestImage.CGContext.SubPixelAlignment.png,low,0
WinObjC,2691,6,3,added,3,0,tests/unittests/CoreGraphics.drawing/data/reference/TestImage.LineDashWithCap.Butt.png,low,0
WinObjC,2691,6,3,added,3,0,tests/unittests/CoreGraphics.drawing/data/reference/TestImage.LineDashWithCap.Round.png,low,0
WinObjC,2691,6,3,added,3,0,tests/unittests/CoreGraphics.drawing/data/reference/TestImage.LineDashWithCap.Square.png,low,0
WinObjC,2691,6,3,added,3,0,tests/unittests/CoreGraphics.drawing/data/reference/TestImage.LineWithCap.Butt.png,low,0
WinObjC,2691,6,3,added,3,0,tests/unittests/CoreGraphics.drawing/data/reference/TestImage.LineWithCap.Round.png,low,0
WinObjC,2691,6,3,added,3,0,tests/unittests/CoreGraphics.drawing/data/reference/TestImage.LineWithCap.Square.png,low,0
WinObjC,2691,6,3,added,3,0,tests/unittests/CoreGraphics.drawing/data/reference/TestImage.LineWithJoin.Bevel.png,low,0
WinObjC,2691,6,3,added,3,0,tests/unittests/CoreGraphics.drawing/data/reference/TestImage.LineWithJoin.Round.png,low,0
WinObjC,2691,6,3,added,3,0,tests/unittests/CoreGraphics.drawing/data/reference/TestImage.LineWithMiter.1.5.png,low,0
WinObjC,2691,6,3,added,3,0,tests/unittests/CoreGraphics.drawing/data/reference/TestImage.LineWithMiter.1.8.png,low,0
WinObjC,2691,6,3,added,3,0,tests/unittests/CoreGraphics.drawing/data/reference/TestImage.LineWithMiter.2.png,low,0
WinObjC,2691,6,3,added,3,0,tests/unittests/CoreGraphics.drawing/data/reference/TestImage.LineWithMiter.3.png,low,0
WinObjC,2691,6,3,added,3,0,tests/unittests/CoreGraphics.drawing/data/reference/TestImage.LineWithPhaseDashes.0.1.1.png,low,0
WinObjC,2691,6,3,added,3,0,tests/unittests/CoreGraphics.drawing/data/reference/TestImage.LineWithPhaseDashes.0.5.2.3.1.png,low,0
WinObjC,2691,6,3,added,3,0,tests/unittests/CoreGraphics.drawing/data/reference/TestImage.LineWithPhaseDashes.0.5.2.png,low,0
WinObjC,2691,6,3,added,3,0,tests/unittests/CoreGraphics.drawing/data/reference/TestImage.LineWithPhaseDashes.1.1.1.png,low,0
WinObjC,2691,6,3,added,3,0,tests/unittests/CoreGraphics.drawing/data/reference/TestImage.LineWithPhaseDashes.5.5.2.png,low,0
WinObjC,2689,1,1,modified,0,1,Frameworks/CoreGraphics/CGGradient.mm,medium,0
WinObjC,2689,1,2,modified,1,1,include/CoreGraphics/CGGradient.h,high,0
WinObjC,2685,4,87,modified,53,34,Frameworks/CoreLocation/CLGeocoder.mm,medium,0
WinObjC,2685,4,10,modified,8,2,include/CoreLocation/CLGeocoder.h,high,0
WinObjC,2685,4,8,modified,5,3,samples/WOCCatalog/WOCCatalog/GeocodingViewController.m,high,0
WinObjC,2683,1,17,modified,10,7,Frameworks/UIKit/UIWebView.mm,medium,0
WinObjC,2680,1,4,modified,3,1,tools/msvc/sbclang.targets,low,1
WinObjC,2677,2,35,modified,19,16,Frameworks/Foundation/Utils.mm,medium,0
WinObjC,2677,2,6,modified,3,3,build/Tests/UnitTests/Foundation.WindowsOnly/Foundation.WindowsOnly.UnitTests.vcxproj,medium,0
WinObjC,2677,2,5,modified,2,3,build/Tests/UnitTests/Foundation.WindowsOnly/Foundation.WindowsOnly.UnitTests.vcxproj.filters,medium,0
WinObjC,2677,2,2,modified,1,1,build/Tests/UnitTests/Foundation/Foundation.UnitTests.vcxproj,medium,0
WinObjC,2677,2,4,modified,2,2,build/Tests/UnitTests/Foundation/Foundation.UnitTests.vcxproj.filters,medium,0
WinObjC,2677,2,5,modified,2,3,include/Foundation/NSObjCRuntime.h,high,0
WinObjC,2677,2,30,renamed,27,3,tests/UnitTests/Foundation/FoundationTests.mm,medium,0
WinObjC,2677,2,97,added,97,0,tests/UnitTests/Foundation/WindowsOnly/FoundationInternalTests.mm,medium,0
WinObjC,2677,2,34,removed,0,34,tests/unittests/Foundation/WindowsOnly/FoundationInternalTests.m,high,0
WinObjC,2676,4,312,modified,140,172,Frameworks/CoreGraphics/CGImage.mm,medium,0
WinObjC,2676,4,52,modified,51,1,tests/unittests/CoreGraphics.drawing/CGContextDrawing_ImageDrawingTests.cpp,high,0
WinObjC,2676,4,4,modified,2,2,tests/unittests/CoreGraphics.drawing/ImageHelpers.cpp,high,0
WinObjC,2676,4,2,modified,1,1,tests/unittests/CoreGraphics.drawing/ImageHelpers.h,high,0
WinObjC,2676,4,3,added,3,0,tests/unittests/CoreGraphics.drawing/data/reference/TestImage.CGContext.ImageInterpolation_High.png,low,0
WinObjC,2676,4,3,added,3,0,tests/unittests/CoreGraphics.drawing/data/reference/TestImage.CGContext.ImageInterpolation_Low.png,low,0
WinObjC,2676,4,3,added,3,0,tests/unittests/CoreGraphics.drawing/data/reference/TestImage.CGContext.ImageInterpolation_Medium.png,low,0
WinObjC,2676,4,3,added,3,0,tests/unittests/CoreGraphics.drawing/data/winobjc_indexed.png,low,0
WinObjC,2674,4,1,modified,0,1,common/winobjc.nuproj.common.targets,low,0
WinObjC,2674,4,84,modified,7,77,common/winobjc.packagereference.override.targets,low,0
WinObjC,2674,4,130,modified,114,16,common/winobjc.versioning.common.targets,low,0
WinObjC,2674,4,3,modified,1,2,msvc/sdk-build.targets,low,0
WinObjC,2674,4,3,modified,2,1,tools/WinObjC.Packaging/WinObjC.Packageable.targets,low,0
WinObjC,2674,4,4,modified,2,2,tools/bin/objc2winmd.exe,medium,0
WinObjC,2673,2,50,modified,39,11,Frameworks/Foundation/NSUUID.mm,medium,0
WinObjC,2673,2,44,modified,36,8,Frameworks/UIKit/UIDevice.mm,medium,0
WinObjC,2673,2,1,modified,1,0,build/Tests/UnitTests/Foundation/Foundation.UnitTests.vcxproj,medium,0
WinObjC,2673,2,1,modified,1,0,build/Tests/UnitTests/Foundation/Foundation.UnitTests.vcxproj.filters,medium,0
WinObjC,2673,2,21,modified,0,21,tests/unittests/Foundation/FoundationTests.m,high,0
WinObjC,2673,2,101,added,101,0,tests/unittests/Foundation/NSUUIDTests.mm,medium,0
WinObjC,2670,3,23,modified,20,3,Frameworks/Foundation/NSOperation.mm,medium,0
WinObjC,2670,3,3,modified,2,1,Frameworks/Foundation/NSOperationInternal.h,high,0
WinObjC,2670,3,44,modified,23,21,Frameworks/Foundation/NSOperationQueue.mm,medium,0
WinObjC,2670,3,6,modified,2,4,Frameworks/OpenGLES/EAGLContext.mm,medium,0
WinObjC,2670,3,5,modified,5,0,Frameworks/UIKit/UITapGestureRecognizer.mm,medium,0
WinObjC,2670,3,5,modified,0,5,include/UIKit/UITapGestureRecognizer.h,high,0
WinObjC,2670,3,84,modified,84,0,tests/unittests/Foundation/NSOperationTests.mm,medium,0
WinObjC,2668,2,24,modified,24,0,Frameworks/UIKit.Xaml/ObjCXamlControls.h,high,0
WinObjC,2668,2,18,added,18,0,Frameworks/UIKit.Xaml/ProgressView.xaml,medium,0
WinObjC,2668,2,111,added,111,0,Frameworks/UIKit.Xaml/ProgressView.xaml.cpp,high,0
WinObjC,2668,2,75,added,75,0,Frameworks/UIKit.Xaml/ProgressView.xaml.h,high,0
WinObjC,2668,2,368,modified,260,108,Frameworks/UIKit/UIProgressView.mm,medium,0
WinObjC,2668,2,18,modified,18,0,Frameworks/UIKit/XamlControls.h,high,0
WinObjC,2668,2,30,modified,30,0,Frameworks/UIKit/XamlControls.mm,medium,0
WinObjC,2668,2,3,modified,3,0,build/Tests/FunctionalTests/FunctionalTests.vcxproj,medium,0
WinObjC,2668,2,9,modified,9,0,build/Tests/FunctionalTests/FunctionalTests.vcxproj.filters,medium,0
WinObjC,2668,2,13,modified,11,2,build/UIKit.Xaml/dll/UIKit.Xaml.vcxproj,medium,0
WinObjC,2668,2,9,modified,6,3,build/UIKit.Xaml/dll/UIKit.Xaml.vcxproj.filters,medium,0
WinObjC,2668,2,6,modified,4,2,build/UIKit/lib/UIKitLib.vcxproj,medium,0
WinObjC,2668,2,13,modified,6,7,include/UIKit/UIProgressView.h,high,0
WinObjC,2668,2,16,modified,14,2,samples/XAMLCatalog/XAMLCatalog.vsimporter/XAMLCatalog-WinStore10/XAMLCatalog.vcxproj,medium,0
WinObjC,2668,2,34,modified,31,3,samples/XAMLCatalog/XAMLCatalog.vsimporter/XAMLCatalog-WinStore10/XAMLCatalog.vcxproj.filters,medium,0
WinObjC,2668,2,6,modified,6,0,samples/XAMLCatalog/XAMLCatalog.xcodeproj/project.pbxproj,high,0
WinObjC,2668,2,3,added,3,0,samples/XAMLCatalog/XAMLCatalog/Images/progress-fill-sample.png,low,0
WinObjC,2668,2,3,added,3,0,samples/XAMLCatalog/XAMLCatalog/Images/progress-track-sample.png,low,0
WinObjC,2668,2,4,modified,4,0,samples/XAMLCatalog/XAMLCatalog/ProgrammaticViewController.m,high,0
WinObjC,2668,2,47,added,47,0,samples/XAMLCatalog/XAMLCatalog/UIKitControls/UIProgressViewController.h,high,0
WinObjC,2668,2,276,added,276,0,samples/XAMLCatalog/XAMLCatalog/UIKitControls/UIProgressViewController.m,high,0
WinObjC,2668,2,1,modified,1,0,tests/functionaltests/Tests/Default.AppXManifest.xml,medium,0
WinObjC,2668,2,933,added,933,0,tests/functionaltests/Tests/UIKitTests/UIProgressViewTests.mm,medium,0
WinObjC,2666,1,6,modified,2,4,Frameworks/OpenGLES/EAGLContext.mm,medium,0
WinObjC,2665,1,2,modified,1,1,Frameworks/Foundation/NSKeyValueCoding.mm,medium,0
WinObjC,2663,1,2,modified,1,1,Frameworks/CoreGraphics/CGContext.mm,medium,0
WinObjC,2663,1,4,modified,2,2,tests/UnitTests/CoreGraphics.drawing/data/reference/TestImage.TextDrawingMode.0.-30.png,low,0
WinObjC,2663,1,4,modified,2,2,tests/UnitTests/CoreGraphics.drawing/data/reference/TestImage.TextDrawingMode.0.0.png,low,0
WinObjC,2663,1,4,modified,2,2,tests/UnitTests/CoreGraphics.drawing/data/reference/TestImage.TextDrawingMode.0.45.png,low,0
WinObjC,2663,1,4,modified,2,2,tests/UnitTests/CoreGraphics.drawing/data/reference/TestImage.TextDrawingMode.1.-30.png,low,0
WinObjC,2663,1,4,modified,2,2,tests/UnitTests/CoreGraphics.drawing/data/reference/TestImage.TextDrawingMode.1.0.png,low,0
WinObjC,2663,1,4,modified,2,2,tests/UnitTests/CoreGraphics.drawing/data/reference/TestImage.TextDrawingMode.1.45.png,low,0
WinObjC,2663,1,4,modified,2,2,tests/UnitTests/CoreGraphics.drawing/data/reference/TestImage.TextDrawingMode.2.-30.png,low,0
WinObjC,2663,1,4,modified,2,2,tests/UnitTests/CoreGraphics.drawing/data/reference/TestImage.TextDrawingMode.2.0.png,low,0
WinObjC,2663,1,4,modified,2,2,tests/UnitTests/CoreGraphics.drawing/data/reference/TestImage.TextDrawingMode.2.45.png,low,0
WinObjC,2663,1,4,modified,2,2,tests/UnitTests/CoreGraphics.drawing/data/reference/TestImage.TextDrawingMode.3.-30.png,low,0
WinObjC,2663,1,4,modified,2,2,tests/UnitTests/CoreGraphics.drawing/data/reference/TestImage.TextDrawingMode.3.0.png,low,0
WinObjC,2663,1,4,modified,2,2,tests/UnitTests/CoreGraphics.drawing/data/reference/TestImage.TextDrawingMode.3.45.png,low,0
WinObjC,2663,1,4,modified,2,2,tests/UnitTests/CoreGraphics.drawing/data/reference/TestImage.TextDrawingMode.4.-30.png,low,0
WinObjC,2663,1,4,modified,2,2,tests/UnitTests/CoreGraphics.drawing/data/reference/TestImage.TextDrawingMode.4.0.png,low,0
WinObjC,2663,1,4,modified,2,2,tests/UnitTests/CoreGraphics.drawing/data/reference/TestImage.TextDrawingMode.4.45.png,low,0
WinObjC,2663,1,4,modified,2,2,tests/UnitTests/CoreGraphics.drawing/data/reference/TestImage.TextDrawingMode.5.-30.png,low,0
WinObjC,2663,1,4,modified,2,2,tests/UnitTests/CoreGraphics.drawing/data/reference/TestImage.TextDrawingMode.5.0.png,low,0
WinObjC,2663,1,4,modified,2,2,tests/UnitTests/CoreGraphics.drawing/data/reference/TestImage.TextDrawingMode.5.45.png,low,0
WinObjC,2663,1,4,modified,2,2,tests/UnitTests/CoreGraphics.drawing/data/reference/TestImage.TextDrawingMode.6.-30.png,low,0
WinObjC,2663,1,4,modified,2,2,tests/UnitTests/CoreGraphics.drawing/data/reference/TestImage.TextDrawingMode.6.0.png,low,0
WinObjC,2663,1,4,modified,2,2,tests/UnitTests/CoreGraphics.drawing/data/reference/TestImage.TextDrawingMode.6.45.png,low,0
WinObjC,2663,1,4,modified,2,2,tests/UnitTests/CoreGraphics.drawing/data/reference/TestImage.TextDrawingMode.7.-30.png,low,0
WinObjC,2663,1,4,modified,2,2,tests/UnitTests/CoreGraphics.drawing/data/reference/TestImage.TextDrawingMode.7.0.png,low,0
WinObjC,2663,1,4,modified,2,2,tests/UnitTests/CoreGraphics.drawing/data/reference/TestImage.TextDrawingMode.7.45.png,low,0
WinObjC,2663,1,1,modified,1,0,tests/unittests/CoreGraphics.drawing/CTDrawingTests.cpp,high,0
WinObjC,2662,5,3,modified,3,0,Frameworks/UIKit/UICGColor.h,high,0
WinObjC,2662,5,64,modified,26,38,Frameworks/UIKit/UICGColor.mm,medium,0
WinObjC,2662,5,55,modified,42,13,Frameworks/UIKit/UIColor.mm,medium,0
WinObjC,2662,5,2,modified,1,1,include/UIKit/UIColor.h,high,0
WinObjC,2662,5,93,modified,56,37,tests/unittests/UIKit/UIColorTests.mm,medium,0
WinObjC,2661,1,5,modified,5,0,Frameworks/UIKit/UITapGestureRecognizer.mm,medium,0
WinObjC,2661,1,5,modified,0,5,include/UIKit/UITapGestureRecognizer.h,high,0
WinObjC,2660,1,3,modified,1,2,msvc/sdk-build.targets,low,0
WinObjC,2660,1,3,modified,2,1,tools/WinObjC.Packaging/WinObjC.Packageable.targets,low,0
WinObjC,2658,3,23,modified,20,3,Frameworks/Foundation/NSOperation.mm,medium,0
WinObjC,2658,3,3,modified,2,1,Frameworks/Foundation/NSOperationInternal.h,high,0
WinObjC,2658,3,44,modified,23,21,Frameworks/Foundation/NSOperationQueue.mm,medium,0
WinObjC,2658,3,84,modified,84,0,tests/unittests/Foundation/NSOperationTests.mm,medium,0
WinObjC,2652,1,30,modified,30,0,Frameworks/UIKit/UIAlertView.mm,medium,0
WinObjC,2650,3,64,modified,39,25,Frameworks/QuartzCore/CALayer.mm,medium,0
WinObjC,2650,3,11,modified,10,1,Frameworks/UIKit/UITouch.mm,medium,0
WinObjC,2650,3,5,modified,4,1,Frameworks/UIKit/UIView.mm,medium,0
WinObjC,2647,6,79,modified,59,20,Frameworks/Foundation/NSKeyValueCoding.mm,medium,0
WinObjC,2647,6,303,modified,28,275,Frameworks/Foundation/NSObject_NSKeyValueArrayAdapter.mm,medium,0
WinObjC,2647,6,135,added,135,0,Frameworks/Foundation/NSObject_NSKeyValueOrderedSetAdapter.mm,medium,0
WinObjC,2647,6,331,added,331,0,Frameworks/Foundation/NSObject_NSKeyValueSetAdapter.mm,medium,0
WinObjC,2647,6,29,removed,0,29,Frameworks/include/NSObject_NSKeyValueArrayAdapter-Internal.h,high,0
WinObjC,2647,6,313,modified,311,2,Frameworks/include/NSObject_NSKeyValueCoding-Internal.h,high,0
WinObjC,2647,6,2,modified,2,0,build/Foundation/lib/FoundationLib.vcxproj,medium,0
WinObjC,2647,6,2,modified,2,0,build/Tests/UnitTests/Foundation/Foundation.UnitTests.vcxproj,medium,0
WinObjC,2647,6,3,modified,3,0,build/Tests/UnitTests/Foundation/Foundation.UnitTests.vcxproj.filters,medium,0
WinObjC,2647,6,8,modified,4,4,include/Foundation/NSKeyValueCoding.h,high,0
WinObjC,2647,6,265,added,265,0,tests/UnitTests/Foundation/NSObject_NSKeyValueOrderedSetAdaptersTests.mm,medium,0
WinObjC,2647,6,322,added,322,0,tests/UnitTests/Foundation/NSObject_NSKeyValueSetAdaptersTests.mm,medium,0
WinObjC,2646,1,0,removed,0,0,msasn1.pdb/A3C1500389CC946516E080DF8C8DEDBE1/download.error,NaN,0
WinObjC,2642,1,4,modified,2,2,tools/WinObjC.Packaging/WinObjC.Packager.targets,low,1
WinObjC,2640,1,0,added,0,0,msasn1.pdb/A3C1500389CC946516E080DF8C8DEDBE1/download.error,NaN,0
WinObjC,2640,1,4,modified,2,2,samples/WOCCatalog/WOCCatalog/CoreLocationViewController.mm,medium,0
WindowsExploits,1,1,0,added,0,0,MS17-010/MS17-010.exe,medium,0
Windows-driver-samples,296,8,8,modified,4,4,audio/sysvad/EndpointsCommon/minwavert.cpp,high,0
Windows-driver-samples,296,8,89,modified,45,44,audio/sysvad/EndpointsCommon/minwavert.h,high,0
Windows-driver-samples,295,1,2,modified,1,1,filesys/fastfat/devctrl.c,high,0
Windows-driver-samples,295,1,4,modified,2,2,filesys/fastfat/fatinit.c,high,0
Windows-driver-samples,295,1,32,modified,16,16,filesys/fastfat/volinfo.c,high,0
Windows-driver-samples,294,1,10,modified,5,5,filesys/fastfat/close.c,high,0
Windows-driver-samples,293,1,2,modified,0,2,bluetooth/serialhcibus/WDK/SerialBusWdk.vcxproj,medium,0
Windows-driver-samples,292,1,6,modified,6,0,print/autoconfig/AutoCnfg.inf,NaN,0
Windows-driver-samples,292,1,3,modified,3,0,print/v4PrintDriverSamples/v4PrintDriver-HostBasedSampleDriver/usb_host_based_sample.inf,NaN,0
Windows-driver-samples,290,1,2,modified,1,1,general/registry/regfltr/exe/common.h,high,0
Windows-driver-samples,288,1,2,modified,1,1,general/ioctl/kmdf/exe/testapp.c,high,0
Windows-driver-samples,287,13,2,renamed,2,0,TrEE/tree.yml,medium,0
Windows-driver-samples,287,13,9,modified,9,0,audio/sysvad/README.md,low,0
Windows-driver-samples,287,13,2,renamed,2,0,audio/sysvad/audio-sysvad.yml,medium,0
Windows-driver-samples,287,13,2,renamed,2,0,avstream/avscamera/avstream-avscamera.yml,medium,0
Windows-driver-samples,287,13,2,renamed,2,0,avstream/avshws/avstream-avshws.yml,medium,0
Windows-driver-samples,287,13,2,renamed,2,0,avstream/avssamp/avstream-avssamp.yml,medium,0
Windows-driver-samples,287,13,4,modified,2,2,avstream/sampledevicemft/README.md,low,0
Windows-driver-samples,287,13,2,renamed,2,0,avstream/sampledevicemft/avstream-sampledevicemft.yml,medium,0
Windows-driver-samples,287,13,10,modified,5,5,avstream/samplemft0/README.md,low,0
Windows-driver-samples,287,13,4,renamed,3,1,avstream/samplemft0/avstream-samplemft0.yml,medium,0
Windows-driver-samples,287,13,2,renamed,2,0,biometrics/biometrics.yml,medium,0
Windows-driver-samples,287,13,2,renamed,2,0,bluetooth/bthecho/bluetooth-bthecho.yml,medium,0
Windows-driver-samples,287,13,2,renamed,2,0,bluetooth/serialhcibus/bluetooth-serialhcibus.yml,medium,0
Windows-driver-samples,287,13,2,renamed,2,0,filesys/cdfs/filesys-cdfs.yml,medium,0
Windows-driver-samples,287,13,2,renamed,2,0,filesys/fastfat/filesys-fastfat.yml,medium,0
Windows-driver-samples,287,13,2,renamed,2,0,filesys/miniFilter/MetadataManager/filesys-minifilter-metadatamanager.yml,medium,0
Windows-driver-samples,287,13,2,renamed,2,0,filesys/miniFilter/NameChanger/filesys-minifilter-namechanger.yml,medium,0
Windows-driver-samples,287,13,2,renamed,2,0,filesys/miniFilter/avscan/filesys-minifilter-avscan.yml,medium,0
Windows-driver-samples,287,13,2,renamed,2,0,filesys/miniFilter/cancelSafe/filesys-minifilter-cancelsafe.yml,medium,0
Windows-driver-samples,287,13,2,renamed,2,0,filesys/miniFilter/cdo/filesys-minifilter-cdo.yml,medium,0
Windows-driver-samples,287,13,2,renamed,2,0,filesys/miniFilter/change/filesys-minifilter-change.yml,medium,0
Windows-driver-samples,287,13,2,renamed,2,0,filesys/miniFilter/ctx/filesys-minifilter-ctx.yml,medium,0
Windows-driver-samples,287,13,2,renamed,2,0,filesys/miniFilter/delete/filesys-minifilter-delete.yml,medium,0
Windows-driver-samples,287,13,2,renamed,2,0,filesys/miniFilter/minispy/filesys-minifilter-minispy.yml,medium,0
Windows-driver-samples,287,13,2,renamed,2,0,filesys/miniFilter/nullFilter/filesys-minifilter-nullfilter.yml,medium,0
Windows-driver-samples,287,13,2,renamed,2,0,filesys/miniFilter/passThrough/filesys-minifilter-passthrough.yml,medium,0
Windows-driver-samples,287,13,2,renamed,2,0,filesys/miniFilter/scanner/filesys-minifilter-scanner.yml,medium,0
Windows-driver-samples,287,13,2,renamed,2,0,filesys/miniFilter/simrep/filesys-minifilter-simrep.yml,medium,0
Windows-driver-samples,287,13,2,renamed,2,0,filesys/miniFilter/swapBuffers/filesys-minifilter-swapbuffers.yml,medium,0
Windows-driver-samples,287,13,1,renamed,1,0,general/DCHU/general-dchu.yml,medium,0
Windows-driver-samples,283,2,6,modified,3,3,bluetooth/serialhcibus/Fdo.c,high,0
Windows-driver-samples,280,1,1,modified,1,0,storage/class/disk/src/disk.c,high,0
Windows-driver-samples,278,1,8,modified,7,1,filesys/cdfs/namesup.c,high,1
Windows-driver-samples,277,1,2,modified,0,2,network/trans/WFPSampler/sys/ClassifyFunctions_BasicPacketModificationCallouts.cpp,high,0
Windows-driver-samples,273,1,26,modified,8,18,filesys/miniFilter/MetadataManager/support.c,high,0
Windows-driver-samples,272,1,0,modified,0,0,avstream/samplemft0/resource.h,high,0
Windows-driver-samples,263,1,2,modified,1,1,network/wlan/WDI/COMMON/HashTable.c,high,0
Windows-driver-samples,263,1,2,modified,1,1,network/wlan/WDI/COMMON/QosGen.c,high,0
Windows-driver-samples,263,1,2,modified,1,1,network/wlan/WDI/HEADER/HashTable.h,high,0
Windows-driver-samples,257,1,241,modified,154,87,avstream/sampledevicemft/basepin.cpp,high,0
Windows-driver-samples,257,1,137,modified,53,84,avstream/sampledevicemft/basepin.h,high,0
Windows-driver-samples,257,1,103,modified,75,28,avstream/sampledevicemft/common.h,high,0
Windows-driver-samples,257,1,306,modified,187,119,avstream/sampledevicemft/multipinmft.cpp,high,0
Windows-driver-samples,257,1,18,modified,15,3,avstream/sampledevicemft/multipinmft.h,high,0
Windows-driver-samples,257,1,1156,modified,856,300,avstream/sampledevicemft/multipinmfthelpers.cpp,high,0
Windows-driver-samples,257,1,311,modified,276,35,avstream/sampledevicemft/multipinmfthelpers.h,high,0
Windows-driver-samples,257,1,718,modified,615,103,avstream/sampledevicemft/multipinmftutils.cpp,high,0
Windows-driver-samples,257,1,24,modified,23,1,avstream/sampledevicemft/stdafx.h,high,0
Windows-driver-samples,256,4,0,renamed,0,0,audio/sysvad/APO/DelayAPO/Delay.cpp,high,0
Windows-driver-samples,256,4,0,renamed,0,0,audio/sysvad/APO/DelayAPO/DelayAPO.h,high,0
Windows-driver-samples,256,4,16,renamed,8,8,audio/sysvad/APO/DelayAPO/DelayAPO.vcxproj,medium,0
Windows-driver-samples,256,4,36,renamed,9,27,audio/sysvad/APO/DelayAPO/DelayAPO.vcxproj.Filters,NaN,0
Windows-driver-samples,256,4,70,added,70,0,audio/sysvad/APO/DelayAPO/DelayAPODll.cpp,high,0
Windows-driver-samples,256,4,2,renamed,0,2,audio/sysvad/APO/DelayAPO/DelayAPODll.def,low,0
Windows-driver-samples,256,4,0,renamed,0,0,audio/sysvad/APO/DelayAPO/DelayAPODll.idl,high,0
Windows-driver-samples,256,4,6,renamed,3,3,audio/sysvad/APO/DelayAPO/DelayAPODll.rc,low,0
Windows-driver-samples,256,4,0,renamed,0,0,audio/sysvad/APO/DelayAPO/DelayAPODll.rgs,NaN,0
Windows-driver-samples,256,4,0,renamed,0,0,audio/sysvad/APO/DelayAPO/DelayAPOInterface.idl,high,0
Windows-driver-samples,256,4,0,renamed,0,0,audio/sysvad/APO/DelayAPO/DelayAPOMFX.cpp,high,0
Windows-driver-samples,256,4,0,renamed,0,0,audio/sysvad/APO/DelayAPO/DelayAPOMFX.rgs,NaN,0
Windows-driver-samples,256,4,0,renamed,0,0,audio/sysvad/APO/DelayAPO/DelayAPOSFX.cpp,high,0
Windows-driver-samples,256,4,0,renamed,0,0,audio/sysvad/APO/DelayAPO/DelayAPOSFX.rgs,NaN,0
Windows-driver-samples,256,4,0,renamed,0,0,audio/sysvad/APO/DelayAPO/Resource.h,high,0
Windows-driver-samples,256,4,0,renamed,0,0,audio/sysvad/APO/DelayAPO/delayapo.png,low,0
Windows-driver-samples,256,4,0,renamed,0,0,audio/sysvad/APO/DelayAPO/makefile,NaN,0
Windows-driver-samples,256,4,0,renamed,0,0,audio/sysvad/APO/DelayAPO/sources,NaN,0
Windows-driver-samples,256,4,0,renamed,0,0,audio/sysvad/APO/Inc/CommonMacros.h,high,0
Windows-driver-samples,256,4,0,renamed,0,0,audio/sysvad/APO/Inc/CustomPropKeys.h,high,0
Windows-driver-samples,256,4,0,renamed,0,0,audio/sysvad/APO/Inc/tlist.h,high,0
Windows-driver-samples,256,4,0,renamed,0,0,audio/sysvad/APO/SwapAPO/Resource.h,high,0
Windows-driver-samples,256,4,0,renamed,0,0,audio/sysvad/APO/SwapAPO/SwapAPO.h,high,0
Windows-driver-samples,256,4,16,renamed,8,8,audio/sysvad/APO/SwapAPO/SwapAPO.vcxproj,medium,0
Windows-driver-samples,256,4,36,renamed,9,27,audio/sysvad/APO/SwapAPO/SwapAPO.vcxproj.Filters,NaN,0
Windows-driver-samples,256,4,72,added,72,0,audio/sysvad/APO/SwapAPO/SwapAPODll.cpp,high,0
Windows-driver-samples,256,4,2,renamed,0,2,audio/sysvad/APO/SwapAPO/SwapAPODll.def,low,0
Windows-driver-samples,256,4,0,renamed,0,0,audio/sysvad/APO/SwapAPO/SwapAPODll.idl,high,0
Windows-driver-samples,256,4,6,renamed,3,3,audio/sysvad/APO/SwapAPO/SwapAPODll.rc,low,0
Windows-driver-samples,256,4,0,renamed,0,0,audio/sysvad/APO/SwapAPO/SwapAPODll.rgs,NaN,0
Windows-driver-samples,254,2,189,modified,0,189,avstream/avscamera/sys/Device.cpp,high,0
Windows-driver-samples,254,2,6,modified,4,2,avstream/avscamera/sys/Sensor.cpp,high,0
Windows-driver-samples,254,2,2,modified,1,1,avstream/avscamera/sys/Sensor.h,high,0
Windows-driver-samples,254,2,2,modified,1,1,avstream/avscamera/sys/SensorSimulation.cpp,high,0
Windows-driver-samples,254,2,1,modified,0,1,avstream/avscamera/sys/Synthesizer.h,high,0
Windows-driver-samples,254,2,12,modified,6,6,avstream/avscamera/sys/hwsim.cpp,high,0
Windows-driver-samples,254,2,8,modified,4,4,avstream/sampledevicemft/multipinmft.cpp,high,0
Windows-driver-samples,254,2,8,modified,4,4,avstream/samplemft0/Package/package.vcxproj,medium,0
Windows-driver-samples,254,2,8,modified,4,4,avstream/samplemft0/SampleMft0.vcxproj,medium,0
Windows-driver-samples,252,2,2,modified,1,1,README.md,low,1
Windows-driver-samples,252,2,12,modified,6,6,audio/sysvad/README.md,low,1
Windows-driver-samples,252,2,2,modified,1,1,avstream/avscamera/README.md,low,1
Windows-driver-samples,252,2,18,modified,9,9,avstream/avshws/README.md,low,1
Windows-driver-samples,252,2,12,modified,6,6,avstream/avssamp/README.md,low,1
Windows-driver-samples,252,2,10,modified,5,5,avstream/sampledevicemft/README.md,low,1
Windows-driver-samples,252,2,14,modified,7,7,avstream/samplemft0/README.md,low,1
Windows-driver-samples,252,2,12,modified,6,6,biometrics/README.md,low,1
Windows-driver-samples,252,2,4,modified,2,2,bluetooth/bthecho/README.md,low,1
Windows-driver-samples,252,2,4,modified,2,2,bluetooth/serialhcibus/README.md,low,1
Windows-driver-samples,252,2,2,modified,1,1,filesys/cdfs/README.md,low,1
Windows-driver-samples,252,2,2,modified,1,1,filesys/fastfat/README.md,low,1
Windows-driver-samples,252,2,4,modified,2,2,filesys/miniFilter/MetadataManager/README.md,low,1
Windows-driver-samples,252,2,4,modified,2,2,filesys/miniFilter/NameChanger/README.md,low,1
Windows-driver-samples,252,2,2,modified,1,1,filesys/miniFilter/avscan/README.md,low,1
Windows-driver-samples,252,2,4,modified,2,2,filesys/miniFilter/cancelSafe/README.md,low,1
Windows-driver-samples,252,2,4,modified,2,2,filesys/miniFilter/cdo/README.md,low,1
Windows-driver-samples,252,2,2,modified,1,1,filesys/miniFilter/change/README.md,low,1
Windows-driver-samples,252,2,4,modified,2,2,filesys/miniFilter/ctx/README.md,low,1
Windows-driver-samples,252,2,4,modified,2,2,filesys/miniFilter/delete/README.md,low,1
Windows-driver-samples,252,2,4,modified,2,2,filesys/miniFilter/minispy/README.md,low,1
Windows-driver-samples,252,2,4,modified,2,2,filesys/miniFilter/nullFilter/README.md,low,1
Windows-driver-samples,252,2,4,modified,2,2,filesys/miniFilter/passThrough/README.md,low,1
Windows-driver-samples,252,2,4,modified,2,2,filesys/miniFilter/scanner/README.md,low,1
Windows-driver-samples,252,2,4,modified,2,2,filesys/miniFilter/simrep/README.md,low,1
Windows-driver-samples,252,2,4,modified,2,2,filesys/miniFilter/swapBuffers/README.md,low,1
Windows-driver-samples,252,2,4,modified,2,2,general/PLX9x5x/README.md,low,1
Windows-driver-samples,252,2,2,modified,1,1,general/SystemDma/wdm/README.md,low,1
Windows-driver-samples,252,2,2,modified,1,1,general/WinHEC 2017 Lab/Toaster Support App/SharedContent/cpp/App.xaml.cpp,high,1
Windows-driver-samples,252,2,2,modified,1,1,general/WinHEC 2017 Lab/Toaster Support App/SharedContent/cpp/MainPage.xaml,medium,1
Windows-driver-samples,246,1,32,removed,0,32,sd/sdiomars/README.md,low,0
Windows-driver-samples,246,1,1124,removed,0,1124,sd/sdiomars/mars.c,high,0
Windows-driver-samples,246,1,200,removed,0,200,sd/sdiomars/mars.h,high,0
Windows-driver-samples,246,1,0,removed,0,0,sd/sdiomars/mars.inx,NaN,0
Windows-driver-samples,246,1,179,removed,0,179,sd/sdiomars/mars.vcxproj,medium,0
Windows-driver-samples,246,1,31,removed,0,31,sd/sdiomars/mars.vcxproj.Filters,NaN,0
Windows-driver-samples,246,1,113,removed,0,113,sd/sdiomars/ntddmars.h,high,0
Windows-driver-samples,246,1,10,removed,0,10,sd/sdiomars/sd-sdiomars.yaml,medium,0
Windows-driver-samples,246,1,28,removed,0,28,sd/sdiomars/sdiomars.sln,low,0
Windows-driver-samples,246,1,103,removed,0,103,storage/ramdisk/README.md,low,0
Windows-driver-samples,246,1,28,removed,0,28,storage/ramdisk/ramdisk.sln,low,0
Windows-driver-samples,246,1,153,removed,0,153,storage/ramdisk/src/WdfRamdisk.vcxproj,medium,0
Windows-driver-samples,246,1,34,removed,0,34,storage/ramdisk/src/WdfRamdisk.vcxproj.Filters,NaN,0
Windows-driver-samples,246,1,347,removed,0,347,storage/ramdisk/src/forward_progress.c,high,0
Windows-driver-samples,246,1,52,removed,0,52,storage/ramdisk/src/forward_progress.h,high,0
Windows-driver-samples,246,1,898,removed,0,898,storage/ramdisk/src/ramdisk.c,high,0
Windows-driver-samples,246,1,196,removed,0,196,storage/ramdisk/src/ramdisk.h,high,0
Windows-driver-samples,246,1,0,removed,0,0,storage/ramdisk/src/ramdisk.inx,NaN,0
Windows-driver-samples,246,1,11,removed,0,11,storage/ramdisk/src/ramdisk.rc,low,0
Windows-driver-samples,246,1,10,removed,0,10,storage/ramdisk/storage-ramdisk.yaml,medium,0
Windows-driver-samples,244,1,4,modified,2,2,filesys/miniFilter/simrep/simrep.c,high,0
Windows-driver-samples,243,1,28,removed,0,28,nfc/NfcSimulator.sln,low,0
Windows-driver-samples,243,1,34,removed,0,34,nfc/Simulator/Inc/NfcSimulatorDDI.h,high,0
Windows-driver-samples,243,1,24,removed,0,24,nfc/Simulator/README.md,low,0
Windows-driver-samples,243,1,271,removed,0,271,nfc/Simulator/Src/Connection.cpp,high,0
Windows-driver-samples,243,1,121,removed,0,121,nfc/Simulator/Src/Connection.h,high,0
Windows-driver-samples,243,1,102,removed,0,102,nfc/Simulator/Src/Constants.h,high,0
Windows-driver-samples,243,1,245,removed,0,245,nfc/Simulator/Src/Device.cpp,high,0
Windows-driver-samples,243,1,55,removed,0,55,nfc/Simulator/Src/Device.h,high,0
Windows-driver-samples,243,1,70,removed,0,70,nfc/Simulator/Src/Driver.cpp,high,0
Windows-driver-samples,243,1,27,removed,0,27,nfc/Simulator/Src/Driver.h,high,0
Windows-driver-samples,243,1,640,removed,0,640,nfc/Simulator/Src/FileContext.cpp,high,0
Windows-driver-samples,243,1,268,removed,0,268,nfc/Simulator/Src/FileContext.h,high,0
Windows-driver-samples,243,1,84,removed,0,84,nfc/Simulator/Src/Internal.h,high,0
Windows-driver-samples,243,1,1,removed,0,1,nfc/Simulator/Src/Internalsrc.cpp,high,0
Windows-driver-samples,243,1,121,removed,0,121,nfc/Simulator/Src/LinkList.h,high,0
Windows-driver-samples,243,1,351,removed,0,351,nfc/Simulator/Src/NfcDriverSim.vcxproj,medium,0
Windows-driver-samples,243,1,69,removed,0,69,nfc/Simulator/Src/NfcDriverSim.vcxproj.Filters,NaN,0
Windows-driver-samples,243,1,6,removed,0,6,nfc/Simulator/Src/NfcSimulator.def,low,0
Windows-driver-samples,243,1,0,removed,0,0,nfc/Simulator/Src/NfcSimulator.inx,NaN,0
Windows-driver-samples,243,1,15,removed,0,15,nfc/Simulator/Src/NfcSimulator.rc,low,0
Windows-driver-samples,243,1,2420,removed,0,2420,nfc/Simulator/Src/Queue.cpp,high,0
Windows-driver-samples,243,1,217,removed,0,217,nfc/Simulator/Src/Queue.h,high,0
Windows-driver-samples,243,1,388,removed,0,388,nfc/Simulator/Src/RoutingTable.cpp,high,0
Windows-driver-samples,243,1,55,removed,0,55,nfc/Simulator/Src/RoutingTable.h,high,0
Windows-driver-samples,243,1,52,removed,0,52,nfc/Simulator/Src/SecureElement.cpp,high,0
Windows-driver-samples,243,1,56,removed,0,56,nfc/Simulator/Src/SecureElement.h,high,0
Windows-driver-samples,243,1,312,removed,0,312,nfc/Simulator/Src/SmartCard.cpp,high,0
Windows-driver-samples,243,1,100,removed,0,100,nfc/Simulator/Src/SmartCard.h,high,0
Windows-driver-samples,243,1,564,removed,0,564,nfc/Simulator/Src/SmartCardReader.cpp,high,0
Windows-driver-samples,243,1,87,removed,0,87,nfc/Simulator/Src/SmartCardReader.h,high,0
Windows-driver-samples,240,0,2,modified,1,1,network/ndis/ndisprot_kmdf/60/ndisprot.h,high,0
Windows-driver-samples,238,1,12,modified,9,3,setup/devcon/devcon.sln,low,0
Windows-driver-samples,238,1,72,modified,72,0,setup/devcon/devcon.vcxproj,medium,0
Windows-driver-samples,237,1,0,added,0,0,network/ndis/netvmini/6x/680/netvmini680.inf,NaN,0
Windows-driver-samples,237,1,50,added,50,0,network/ndis/netvmini/6x/680/netvmini680.rc,low,0
Windows-driver-samples,237,1,217,added,217,0,network/ndis/netvmini/6x/680/netvmini680.vcxproj,medium,0
Windows-driver-samples,237,1,58,added,58,0,network/ndis/netvmini/6x/680/netvmini680.vcxproj.Filters,NaN,0
Windows-driver-samples,237,1,11,modified,11,0,network/ndis/netvmini/6x/adapter.c,high,0
Windows-driver-samples,237,1,9,modified,9,0,network/ndis/netvmini/6x/adapter.h,high,0
Windows-driver-samples,237,1,208,modified,208,0,network/ndis/netvmini/6x/ctrlpath.c,high,0
Windows-driver-samples,237,1,4,modified,3,1,network/ndis/netvmini/6x/ctrlpath.h,high,0
Windows-driver-samples,237,1,9,modified,9,0,network/ndis/netvmini/6x/miniport.c,high,0
Windows-driver-samples,237,1,3,modified,3,0,network/ndis/netvmini/6x/miniport.h,high,0
Windows-driver-samples,237,1,1,modified,1,0,network/ndis/netvmini/6x/netvmin6.h,high,0
Windows-driver-samples,237,1,13,modified,13,0,network/ndis/netvmini/6x/netvmini.sln,low,0
Windows-driver-samples,237,1,1283,added,1283,0,network/ndis/netvmini/6x/rssv2.c,high,0
Windows-driver-samples,237,1,136,added,136,0,network/ndis/netvmini/6x/rssv2.h,high,0
Windows-driver-samples,237,1,657,added,657,0,network/ndis/netvmini/6x/rssv2lib.c,high,0
Windows-driver-samples,237,1,205,added,205,0,network/ndis/netvmini/6x/rssv2lib.h,high,0
Windows-driver-samples,233,0,10,modified,5,5,general/toaster/toastDrv/kmdf/filter/sideband/filter.c,high,0
Windows-driver-samples,232,0,8,modified,4,4,general/ioctl/wdm/exe/testapp.c,high,0
Windows-driver-samples,231,2,0,modified,0,0,general/DCHU/osrfx2_DCHU_base/osrfx2_DCHU_base/osrfx2_DCHU_base.inx,NaN,0
Windows-driver-samples,231,2,20,modified,16,4,general/DCHU/osrfx2_DCHU_base/osrfx2_DCHU_base/osrfx2_DCHU_base.vcxproj,medium,0
Windows-driver-samples,231,2,10,modified,5,5,general/DCHU/osrfx2_DCHU_base/osrfx2_DCHU_usersvc/osrfx2_DCHU_usersvc.vcxproj,medium,0
Windows-driver-samples,231,2,10,modified,5,5,general/DCHU/osrfx2_DCHU_extension_loose/osrfx2_DCHU_componentsoftware/osrfx2_DCHU_componentsoftware.vcxproj,medium,0
Windows-driver-samples,231,2,43,modified,4,39,general/DCHU/osrfx2_DCHU_extension_loose/osrfx2_DCHU_extension.sln,low,0
Windows-driver-samples,231,2,5,modified,2,3,general/DCHU/osrfx2_DCHU_extension_loose/osrfx2_DCHU_extension/osrfx2_DCHU_extension.inx,NaN,0
Windows-driver-samples,231,2,48,modified,0,48,general/DCHU/osrfx2_DCHU_extension_loose/osrfx2_DCHU_extension/osrfx2_DCHU_extension.vcxproj,medium,0
Windows-driver-samples,231,2,25,modified,8,17,general/DCHU/osrfx2_DCHU_extension_tight/osrfx2_DCHU_componentsoftware/osrfx2_DCHU_componentsoftware.vcxproj,medium,0
Windows-driver-samples,231,2,21,modified,8,13,general/DCHU/osrfx2_DCHU_extension_tight/osrfx2_DCHU_extension.sln,low,0
Windows-driver-samples,231,2,4,modified,1,3,general/DCHU/osrfx2_DCHU_extension_tight/osrfx2_DCHU_extension/osrfx2_DCHU_extension.inx,NaN,0
Windows-driver-samples,231,2,129,modified,10,119,general/DCHU/osrfx2_DCHU_extension_tight/osrfx2_DCHU_extension/osrfx2_DCHU_extension.vcxproj,medium,0
Windows-driver-samples,225,1,2,modified,1,1,filesys/miniFilter/simrep/simrep.c,high,0
Windows-driver-samples,222,1,105,removed,0,105,input/hiddigi/SynapticsTouch/README.md,low,0
Windows-driver-samples,222,1,0,removed,0,0,input/hiddigi/SynapticsTouch/SynapticsTouch.inx,NaN,0
Windows-driver-samples,222,1,28,removed,0,28,input/hiddigi/SynapticsTouch/SynapticsTouch.sln,low,0
Windows-driver-samples,222,1,200,removed,0,200,input/hiddigi/SynapticsTouch/SynapticsTouch.vcxproj,medium,0
Windows-driver-samples,222,1,61,removed,0,61,input/hiddigi/SynapticsTouch/SynapticsTouch.vcxproj.Filters,NaN,0
Windows-driver-samples,222,1,203,removed,0,203,input/hiddigi/SynapticsTouch/controller.h,high,0
Windows-driver-samples,222,1,480,removed,0,480,input/hiddigi/SynapticsTouch/device.c,high,0
Windows-driver-samples,222,1,32,removed,0,32,input/hiddigi/SynapticsTouch/device.h,high,0
Windows-driver-samples,222,1,319,removed,0,319,input/hiddigi/SynapticsTouch/driver.c,high,0
Windows-driver-samples,222,1,29,removed,0,29,input/hiddigi/SynapticsTouch/driver.h,high,0
Windows-driver-samples,222,1,769,removed,0,769,input/hiddigi/SynapticsTouch/hid.c,high,0
Windows-driver-samples,222,1,85,removed,0,85,input/hiddigi/SynapticsTouch/hid.h,high,0
Windows-driver-samples,222,1,328,removed,0,328,input/hiddigi/SynapticsTouch/idle.c,high,0
Windows-driver-samples,222,1,54,removed,0,54,input/hiddigi/SynapticsTouch/idle.h,high,0
Windows-driver-samples,222,1,1168,removed,0,1168,input/hiddigi/SynapticsTouch/init.c,high,0
Windows-driver-samples,222,1,10,removed,0,10,input/hiddigi/SynapticsTouch/input-hiddigi-synapticstouch.yaml,medium,0
Windows-driver-samples,222,1,73,removed,0,73,input/hiddigi/SynapticsTouch/internal.h,high,0
Windows-driver-samples,222,1,272,removed,0,272,input/hiddigi/SynapticsTouch/power.c,high,0
Windows-driver-samples,222,1,180,removed,0,180,input/hiddigi/SynapticsTouch/queue.c,high,0
Windows-driver-samples,222,1,24,removed,0,24,input/hiddigi/SynapticsTouch/queue.h,high,0
Windows-driver-samples,222,1,722,removed,0,722,input/hiddigi/SynapticsTouch/registry.c,high,0
Windows-driver-samples,222,1,864,removed,0,864,input/hiddigi/SynapticsTouch/report.c,high,0
Windows-driver-samples,222,1,526,removed,0,526,input/hiddigi/SynapticsTouch/resolutions.c,high,0
Windows-driver-samples,222,1,66,removed,0,66,input/hiddigi/SynapticsTouch/resolutions.h,high,0
Windows-driver-samples,222,1,579,removed,0,579,input/hiddigi/SynapticsTouch/rmiinternal.h,high,0
Windows-driver-samples,222,1,512,removed,0,512,input/hiddigi/SynapticsTouch/spb.c,high,0
Windows-driver-samples,222,1,67,removed,0,67,input/hiddigi/SynapticsTouch/spb.h,high,0
Windows-driver-samples,222,1,49,removed,0,49,input/hiddigi/SynapticsTouch/trace.h,high,0
Windows-driver-samples,220,1,18,modified,1,17,simbatt/func/wdf.c,high,0
Windows-driver-samples,217,1,17,modified,13,4,serial/serial/utils.c,high,0
Windows-driver-samples,215,2,12,modified,0,12,general/SystemDma/wdm/exe/SystemDmaApp.vcxproj,medium,0
Windows-driver-samples,215,2,12,modified,0,12,general/cancel/exe/canclapp.vcxproj,medium,0
Windows-driver-samples,215,2,12,modified,0,12,general/event/exe/event.vcxproj,medium,0
Windows-driver-samples,215,2,12,modified,0,12,general/ioctl/wdm/exe/ioctlapp.vcxproj,medium,0
Windows-driver-samples,215,2,4,modified,0,4,general/pcidrv/test/myping.vcxproj,medium,0
Windows-driver-samples,215,2,4,modified,0,4,hid/firefly/app/flicker.vcxproj,medium,0
Windows-driver-samples,215,2,4,modified,0,4,hid/vhidmini2/app/testvhid.vcxproj,medium,0
Windows-driver-samples,215,2,20,modified,0,20,nfc/Simulator/Src/NfcDriverSim.vcxproj,medium,0
Windows-driver-samples,214,0,10,added,10,0,TrEE/README.md,low,0
Windows-driver-samples,214,0,10,added,10,0,TrEE/tree.yaml,medium,0
Windows-driver-samples,214,0,10,added,10,0,audio/sysvad/audio-sysvad.yaml,medium,0
Windows-driver-samples,214,0,10,added,10,0,avstream/avscamera/avstream-avscamera.yaml,medium,0
Windows-driver-samples,214,0,10,added,10,0,avstream/avshws/avstream-avshws.yaml,medium,0
Windows-driver-samples,214,0,10,added,10,0,avstream/avssamp/avstream-avssamp.yaml,medium,0
Windows-driver-samples,214,0,10,added,10,0,avstream/sampledevicemft/avstream-sampledevicemft.yaml,medium,0
Windows-driver-samples,214,0,10,added,10,0,avstream/samplemft0/avstream-samplemft0.yaml,medium,0
Windows-driver-samples,214,0,10,added,10,0,biometrics/biometrics.yaml,medium,0
Windows-driver-samples,214,0,10,added,10,0,bluetooth/bthecho/bluetooth-bthecho.yaml,medium,0
Windows-driver-samples,214,0,10,added,10,0,bluetooth/serialhcibus/bluetooth-serialhcibus.yaml,medium,0
Windows-driver-samples,214,0,10,added,10,0,filesys/cdfs/filesys-cdfs.yaml,medium,0
Windows-driver-samples,214,0,10,added,10,0,filesys/fastfat/filesys-fastfat.yaml,medium,0
Windows-driver-samples,214,0,10,added,10,0,filesys/miniFilter/MetadataManager/filesys-minifilter-metadatamanager.yaml,medium,0
Windows-driver-samples,214,0,10,added,10,0,filesys/miniFilter/NameChanger/filesys-minifilter-namechanger.yaml,medium,0
Windows-driver-samples,214,0,10,added,10,0,filesys/miniFilter/avscan/filesys-minifilter-avscan.yaml,medium,0
Windows-driver-samples,214,0,10,added,10,0,filesys/miniFilter/cancelSafe/filesys-minifilter-cancelsafe.yaml,medium,0
Windows-driver-samples,214,0,10,added,10,0,filesys/miniFilter/cdo/filesys-minifilter-cdo.yaml,medium,0
Windows-driver-samples,214,0,10,added,10,0,filesys/miniFilter/change/filesys-minifilter-change.yaml,medium,0
Windows-driver-samples,214,0,10,added,10,0,filesys/miniFilter/ctx/filesys-minifilter-ctx.yaml,medium,0
Windows-driver-samples,214,0,10,added,10,0,filesys/miniFilter/delete/filesys-minifilter-delete.yaml,medium,0
Windows-driver-samples,214,0,10,added,10,0,filesys/miniFilter/minispy/filesys-minifilter-minispy.yaml,medium,0
Windows-driver-samples,214,0,10,added,10,0,filesys/miniFilter/nullFilter/filesys-minifilter-nullfilter.yaml,medium,0
Windows-driver-samples,214,0,10,added,10,0,filesys/miniFilter/passThrough/filesys-minifilter-passthrough.yaml,medium,0
Windows-driver-samples,214,0,10,added,10,0,filesys/miniFilter/scanner/filesys-minifilter-scanner.yaml,medium,0
Windows-driver-samples,214,0,10,added,10,0,filesys/miniFilter/simrep/filesys-minifilter-simrep.yaml,medium,0
Windows-driver-samples,214,0,10,added,10,0,filesys/miniFilter/swapBuffers/filesys-minifilter-swapbuffers.yaml,medium,0
Windows-driver-samples,214,0,10,added,10,0,general/DCHU/general-dchu.yaml,medium,0
Windows-driver-samples,214,0,10,added,10,0,general/PLX9x5x/general-plx9x5x.yaml,medium,0
Windows-driver-samples,214,0,10,added,10,0,general/SystemDma/wdm/general-systemdma-wdm.yaml,medium,0
Windows-driver-samples,213,1,5,modified,2,3,simbatt/func/wdf.c,high,1
Windows-driver-samples,212,1,49,modified,48,1,simbatt/func/wdf.c,high,2
Windows-driver-samples,211,0,4,modified,2,2,avstream/sampledevicemft/README.md,low,1
Windows-driver-samples,209,0,7,modified,6,1,filesys/cdfs/resrcsup.c,high,0
Windows-driver-samples,208,1,38,modified,21,17,print/XPSDrvSmpl/README.md,low,0
Windows-driver-samples,207,1,26,modified,8,18,filesys/miniFilter/MetadataManager/support.c,high,0
Windows-driver-samples,195,1,10,modified,6,4,hid/hclient/hclient.c,high,0
Windows-driver-samples,194,2,10,modified,6,4,hid/hclient/hclient.c,high,0
Windows-driver-samples,194,2,4,modified,2,2,hid/hclient/pnp.c,high,0
Windows-driver-samples,193,0,22,modified,21,1,avstream/avscamera/common/MetadataInternal.h,high,0
Windows-driver-samples,193,0,559,modified,264,295,avstream/avscamera/mft0/MFT0Impl.cpp,high,0
Windows-driver-samples,193,0,12,modified,0,12,avstream/avscamera/mft0/MFT0Impl.h,high,0
Windows-driver-samples,193,0,8,modified,4,4,avstream/avscamera/sys/AvsCamera.vcxproj,medium,0
Windows-driver-samples,193,0,3,modified,2,1,avstream/avscamera/sys/AvsCameraFilter.cpp,high,0
Windows-driver-samples,193,0,391,added,391,0,avstream/avscamera/sys/CameraSimulatorCommon.h,high,0
Windows-driver-samples,193,0,335,modified,259,76,avstream/avscamera/sys/Capture.cpp,high,0
Windows-driver-samples,193,0,1,modified,0,1,avstream/avscamera/sys/Capture.h,high,0
Windows-driver-samples,193,0,386,modified,1,385,avstream/avscamera/sys/Common.h,high,0
Windows-driver-samples,193,0,2,modified,1,1,avstream/avscamera/sys/Device.cpp,high,0
Windows-driver-samples,193,0,44,modified,22,22,avstream/avscamera/sys/NV12Synthesizer.cpp,high,0
Windows-driver-samples,193,0,1,modified,1,0,avstream/avscamera/sys/NV12Synthesizer.h,high,0
Windows-driver-samples,193,0,6,modified,6,0,avstream/avscamera/sys/Sensor.cpp,high,0
Windows-driver-samples,193,0,1,modified,1,0,avstream/avscamera/sys/Sensor.h,high,0
Windows-driver-samples,193,0,33,modified,33,0,avstream/avscamera/sys/SensorSimulation.cpp,high,0
Windows-driver-samples,193,0,4,modified,3,1,avstream/avscamera/sys/SensorSimulation.h,high,0
Windows-driver-samples,193,0,8,modified,4,4,avstream/avscamera/sys/Synthesizer.h,high,0
Windows-driver-samples,193,0,2,modified,1,1,avstream/avscamera/sys/Timer.h,high,0
Windows-driver-samples,193,0,60,modified,59,1,avstream/avscamera/sys/Util.cpp,high,0
Windows-driver-samples,193,0,39,modified,34,5,avstream/avscamera/sys/Util.h,high,0
Windows-driver-samples,193,0,2,modified,1,1,avstream/avscamera/sys/YUVSynthesizer.h,high,0
Windows-driver-samples,193,0,0,modified,0,0,avstream/avscamera/sys/avscamera.inf,NaN,0
Windows-driver-samples,193,0,239,modified,237,2,avstream/avscamera/sys/filter.cpp,high,0
Windows-driver-samples,193,0,29,modified,29,0,avstream/avscamera/sys/filter.h,high,0
Windows-driver-samples,193,0,8,modified,4,4,avstream/avscamera/sys/hwsim.cpp,high,0
Windows-driver-samples,193,0,4,modified,2,2,avstream/avscamera/sys/imagehwsim.cpp,high,0
Windows-driver-samples,193,0,10,modified,5,5,avstream/avshws/README.md,low,1
Windows-driver-samples,193,0,148,modified,125,23,avstream/avshws/avshws.h,high,0
Windows-driver-samples,193,0,4,modified,2,2,avstream/avshws/avshws.inf,NaN,0
Windows-driver-samples,193,0,343,modified,193,150,avstream/avshws/device.cpp,high,0
Windows-driver-samples,184,1,14,renamed,7,7,tools/dv/samples/DV-FailDriver-WDM/driver/defect_toastmon.inf,NaN,0
Windows-driver-samples,184,1,4,modified,2,2,tools/dv/samples/DV-FailDriver-WDM/driver/defect_toastmon.vcxproj,medium,0
Windows-driver-samples,184,1,10,modified,5,5,tools/dv/samples/DV-FailDriver-WDM/driver/defect_toastmon.vcxproj.Filters,NaN,0
Windows-driver-samples,182,1,0,added,0,0,general/WinHEC 2017/Optimizing Windows Performance/WinHEC_2017.zip,low,0
Windows-driver-samples,181,2,0,modified,0,0,general/WinHEC 2017 Lab/WinHEC 2017 Lab.docx,NaN,0
Windows-driver-samples,181,2,0,modified,0,0,general/WinHEC 2017 Lab/WinHEC 2017 Lab.zip,low,0
Windows-driver-samples,179,1,0,added,0,0,general/WinHEC 2017 Lab/PlugInToaster/devcon.exe,medium,0
Windows-driver-samples,179,1,0,added,0,0,general/WinHEC 2017 Lab/PlugInToaster/plug.exe,medium,0
Windows-driver-samples,179,1,2,added,2,0,general/WinHEC 2017 Lab/PlugInToaster/unplug.bat,medium,0
Windows-driver-samples,179,1,116,added,116,0,general/WinHEC 2017 Lab/Toaster Driver/Service/HsaService.cpp,high,0
Windows-driver-samples,179,1,148,added,148,0,general/WinHEC 2017 Lab/Toaster Driver/Service/Metering.cpp,high,0
Windows-driver-samples,179,1,29,added,29,0,general/WinHEC 2017 Lab/Toaster Driver/Service/Metering.h,high,0
Windows-driver-samples,179,1,51,added,51,0,general/WinHEC 2017 Lab/Toaster Driver/Service/RpcInterface.Idl,NaN,0
Windows-driver-samples,179,1,17,added,17,0,general/WinHEC 2017 Lab/Toaster Driver/Service/RpcInterface.acf,NaN,0
Windows-driver-samples,179,1,476,added,476,0,general/WinHEC 2017 Lab/Toaster Driver/Service/RpcInterface_c.c,high,0
Windows-driver-samples,179,1,103,added,103,0,general/WinHEC 2017 Lab/Toaster Driver/Service/RpcInterface_h.h,high,0
Windows-driver-samples,179,1,430,added,430,0,general/WinHEC 2017 Lab/Toaster Driver/Service/RpcInterface_s.c,high,0
Windows-driver-samples,179,1,320,added,320,0,general/WinHEC 2017 Lab/Toaster Driver/Service/RpcServer.cpp,high,0
Windows-driver-samples,179,1,16,added,16,0,general/WinHEC 2017 Lab/Toaster Driver/Service/RpcServer.h,high,0
Windows-driver-samples,179,1,284,added,284,0,general/WinHEC 2017 Lab/Toaster Driver/Service/RpcServer.vcxproj,medium,0
Windows-driver-samples,179,1,76,added,76,0,general/WinHEC 2017 Lab/Toaster Driver/Service/RpcServer.vcxproj.filters,medium,0
Windows-driver-samples,179,1,155,added,155,0,general/WinHEC 2017 Lab/Toaster Driver/Service/SampleService.cpp,high,0
Windows-driver-samples,179,1,46,added,46,0,general/WinHEC 2017 Lab/Toaster Driver/Service/SampleService.h,high,0
Windows-driver-samples,179,1,566,added,566,0,general/WinHEC 2017 Lab/Toaster Driver/Service/ServiceBase.cpp,high,0
Windows-driver-samples,179,1,121,added,121,0,general/WinHEC 2017 Lab/Toaster Driver/Service/ServiceBase.h,high,0
Windows-driver-samples,179,1,191,added,191,0,general/WinHEC 2017 Lab/Toaster Driver/Service/ServiceInstaller.cpp,high,0
Windows-driver-samples,179,1,57,added,57,0,general/WinHEC 2017 Lab/Toaster Driver/Service/ServiceInstaller.h,high,0
Windows-driver-samples,179,1,8,added,8,0,general/WinHEC 2017 Lab/Toaster Driver/Service/stdafx.cpp,high,0
Windows-driver-samples,179,1,15,added,15,0,general/WinHEC 2017 Lab/Toaster Driver/Service/stdafx.h,high,0
Windows-driver-samples,179,1,8,added,8,0,general/WinHEC 2017 Lab/Toaster Driver/Service/targetver.h,high,0
Windows-driver-samples,179,1,40,added,40,0,general/WinHEC 2017 Lab/Toaster Driver/toaster.sln,low,0
Windows-driver-samples,179,1,80,added,80,0,general/WinHEC 2017 Lab/Toaster Driver/toaster/driver.h,high,0
Windows-driver-samples,179,1,167,added,167,0,general/WinHEC 2017 Lab/Toaster Driver/toaster/public.h,high,0
Windows-driver-samples,179,1,418,added,418,0,general/WinHEC 2017 Lab/Toaster Driver/toaster/toaster.c,high,0
Windows-driver-samples,179,1,134,added,134,0,general/WinHEC 2017 Lab/Toaster Driver/toaster/toaster.h,high,0
Windows-driver-samples,179,1,25,added,25,0,general/WinHEC 2017 Lab/Toaster Driver/toaster/toaster.inx,NaN,0
Windows-driver-samples,178,0,3,modified,2,1,general/ioctl/kmdf/exe/testapp.c,high,0
Windows-driver-samples,176,1,0,renamed,0,0,tools/dv/samples/DV-FailDriver-WDM/README.md,low,0
Windows-driver-samples,176,1,0,renamed,0,0,tools/dv/samples/DV-FailDriver-WDM/defect_toastmon.c,high,0
Windows-driver-samples,176,1,0,renamed,0,0,tools/dv/samples/DV-FailDriver-WDM/defect_toastmon.h,high,0
Windows-driver-samples,176,1,3,renamed,2,1,tools/dv/samples/DV-FailDriver-WDM/defect_toastmon.inf,NaN,0
Windows-driver-samples,176,1,0,renamed,0,0,tools/dv/samples/DV-FailDriver-WDM/defect_toastmon.rc,low,0
Windows-driver-samples,176,1,0,renamed,0,0,tools/dv/samples/DV-FailDriver-WDM/driver.h,high,0
Windows-driver-samples,176,1,32,added,32,0,tools/dv/samples/DV-FailDriver-WDM/driver/DV-FailDriver-WDM.sln,low,0
Windows-driver-samples,176,1,145,added,145,0,tools/dv/samples/DV-FailDriver-WDM/driver/defect_toastmon.vcxproj,medium,0
Windows-driver-samples,176,1,39,added,39,0,tools/dv/samples/DV-FailDriver-WDM/driver/defect_toastmon.vcxproj.Filters,NaN,0
Windows-driver-samples,176,1,0,renamed,0,0,tools/dv/samples/DV-FailDriver-WDM/public.h,high,0
Windows-driver-samples,176,1,0,renamed,0,0,tools/dv/samples/DV-FailDriver-WDM/wmi.c,high,0
Windows-driver-samples,175,1,1,modified,0,1,general/pcidrv/kmdf/PCIDRV.C,NaN,0
Windows-driver-samples,173,0,9,modified,9,0,print/OEM Printer Customization Plug-in Samples/README.md,low,0
Windows-driver-samples,171,8,5,added,5,0,print/.gitignore,low,0
Windows-driver-samples,171,8,0,added,0,0,print/OEM Printer Customization Plug-in Samples/C++/CUSTOMDRV.HLP,NaN,0
Windows-driver-samples,171,8,2858,added,2858,0,print/OEM Printer Customization Plug-in Samples/C++/PSUIRep/Features.cpp,high,0
Windows-driver-samples,171,8,236,added,236,0,print/OEM Printer Customization Plug-in Samples/C++/PSUIRep/Features.h,high,0
Windows-driver-samples,171,8,457,added,457,0,print/OEM Printer Customization Plug-in Samples/C++/PSUIRep/Helper.cpp,high,0
Windows-driver-samples,171,8,214,added,214,0,print/OEM Printer Customization Plug-in Samples/C++/PSUIRep/Helper.h,high,0
Windows-driver-samples,171,8,260,added,260,0,print/OEM Printer Customization Plug-in Samples/C++/PSUIRep/OEMUI.rc,low,0
Windows-driver-samples,171,8,1066,added,1066,0,print/OEM Printer Customization Plug-in Samples/C++/PSUIRep/PSUIREP.vcxproj,medium,0
Windows-driver-samples,171,8,397,added,397,0,print/OEM Printer Customization Plug-in Samples/C++/PSUIRep/PSUIREP.vcxproj.Filters,NaN,0
Windows-driver-samples,171,8,315,added,315,0,print/OEM Printer Customization Plug-in Samples/C++/PSUIRep/StringUtils.cpp,high,0
Windows-driver-samples,171,8,23,added,23,0,print/OEM Printer Customization Plug-in Samples/C++/PSUIRep/StringUtils.h,high,0
Windows-driver-samples,171,8,405,added,405,0,print/OEM Printer Customization Plug-in Samples/C++/PSUIRep/debug.cpp,high,0
Windows-driver-samples,171,8,166,added,166,0,print/OEM Printer Customization Plug-in Samples/C++/PSUIRep/debug.h,high,0
Windows-driver-samples,171,8,193,added,193,0,print/OEM Printer Customization Plug-in Samples/C++/PSUIRep/devmode.cpp,high,0
Windows-driver-samples,171,8,56,added,56,0,print/OEM Printer Customization Plug-in Samples/C++/PSUIRep/devmode.h,high,0
Windows-driver-samples,171,8,49,added,49,0,print/OEM Printer Customization Plug-in Samples/C++/PSUIRep/dllentry.cpp,high,0
Windows-driver-samples,171,8,24,added,24,0,print/OEM Printer Customization Plug-in Samples/C++/PSUIRep/globals.cpp,high,0
Windows-driver-samples,171,8,31,added,31,0,print/OEM Printer Customization Plug-in Samples/C++/PSUIRep/globals.h,high,0
Windows-driver-samples,171,8,709,added,709,0,print/OEM Printer Customization Plug-in Samples/C++/PSUIRep/intrface.cpp,high,0
Windows-driver-samples,171,8,220,added,220,0,print/OEM Printer Customization Plug-in Samples/C++/PSUIRep/intrface.h,high,0
Windows-driver-samples,171,8,1042,added,1042,0,print/OEM Printer Customization Plug-in Samples/C++/PSUIRep/oemui.cpp,high,0
Windows-driver-samples,171,8,33,added,33,0,print/OEM Printer Customization Plug-in Samples/C++/PSUIRep/oemui.h,high,0
Windows-driver-samples,171,8,55,added,55,0,print/OEM Printer Customization Plug-in Samples/C++/PSUIRep/precomp.h,high,0
Windows-driver-samples,171,8,1,added,1,0,print/OEM Printer Customization Plug-in Samples/C++/PSUIRep/precompsrc.cpp,high,0
Windows-driver-samples,171,8,3,added,3,0,print/OEM Printer Customization Plug-in Samples/C++/PSUIRep/psuirep.def,low,0
Windows-driver-samples,171,8,92,added,92,0,print/OEM Printer Customization Plug-in Samples/C++/PSUIRep/resource.h,high,0
Windows-driver-samples,171,8,763,added,763,0,print/OEM Printer Customization Plug-in Samples/C++/PTPCPlPr/install/ptpcplpr.gpd,NaN,0
Windows-driver-samples,171,8,107,added,107,0,print/OEM Printer Customization Plug-in Samples/C++/PTPCPlPr/install/ptpcplpr.inf,NaN,0
Windows-driver-samples,171,8,3,added,3,0,print/OEM Printer Customization Plug-in Samples/C++/PTPCPlPr/install/ptpcplpr.ini,NaN,0
Windows-driver-samples,171,8,904,added,904,0,print/OEM Printer Customization Plug-in Samples/C++/PTPCPlPr/src/PTPCPLPR.vcxproj,medium,0
Windows-driver-samples,170,0,2,modified,1,1,general/toaster/toastDrv/README.md,low,0
Windows-driver-samples,170,0,2,modified,1,1,general/umdfSkeleton/README.md,low,0
Windows-driver-samples,170,0,2,modified,1,1,serial/VirtualSerial/README.md,low,0
Windows-driver-samples,170,0,2,modified,1,1,usb/wdf_osrfx2_lab/README.md,low,0
Windows-driver-samples,167,0,2,modified,1,1,filesys/miniFilter/cdo/README.md,low,1
Windows-driver-samples,167,0,13,modified,11,2,sensors/ADXL345Acc/readme.md,low,0
Windows-driver-samples,167,0,11,modified,10,1,sensors/Activity/readme.md,low,0
Windows-driver-samples,167,0,13,modified,11,2,sensors/CustomSensors/readme.md,low,0
Windows-driver-samples,167,0,11,modified,10,1,sensors/Fusion/readme.md,low,0
Windows-driver-samples,167,0,11,modified,10,1,sensors/Pedometer/readme.md,low,0
Windows-driver-samples,167,0,9,modified,9,0,sensors/SensorsComboDriver/readme.md,low,0
Windows-driver-samples,167,0,11,modified,10,1,sensors/SimpleDeviceOrientationSensor/readme.md,low,0
Windows-driver-samples,166,0,4,modified,4,0,README.md,low,1
Windows-driver-samples,166,0,9,modified,9,0,audio/sysvad/README.md,low,1
Windows-driver-samples,166,0,9,modified,9,0,avstream/avscamera/README.md,low,1
Windows-driver-samples,166,0,9,modified,9,0,avstream/avshws/README.md,low,1
Windows-driver-samples,166,0,9,modified,9,0,avstream/avssamp/README.md,low,1
Windows-driver-samples,166,0,9,modified,9,0,avstream/samplemft0/README.md,low,1
Windows-driver-samples,166,0,10,modified,10,0,biometrics/README.md,low,1
Windows-driver-samples,166,0,9,modified,9,0,bluetooth/bthecho/README.md,low,1
Windows-driver-samples,166,0,9,modified,9,0,bluetooth/serialhcibus/README.md,low,1
Windows-driver-samples,166,0,10,modified,10,0,filesys/cdfs/README.md,low,1
Windows-driver-samples,166,0,11,modified,11,0,filesys/fastfat/README.md,low,1
Windows-driver-samples,166,0,10,modified,10,0,filesys/miniFilter/MetadataManager/README.md,low,1
Windows-driver-samples,166,0,10,modified,10,0,filesys/miniFilter/NameChanger/README.md,low,1
Windows-driver-samples,166,0,10,modified,10,0,filesys/miniFilter/avscan/README.md,low,1
Windows-driver-samples,166,0,10,modified,10,0,filesys/miniFilter/cancelSafe/README.md,low,1
Windows-driver-samples,166,0,10,modified,10,0,filesys/miniFilter/cdo/README.md,low,1
Windows-driver-samples,166,0,10,modified,10,0,filesys/miniFilter/change/README.md,low,1
Windows-driver-samples,166,0,10,modified,10,0,filesys/miniFilter/ctx/README.md,low,1
Windows-driver-samples,166,0,9,modified,9,0,filesys/miniFilter/delete/README.md,low,1
Windows-driver-samples,166,0,10,modified,10,0,filesys/miniFilter/minispy/README.md,low,1
Windows-driver-samples,166,0,9,modified,9,0,filesys/miniFilter/nullFilter/README.md,low,1
Windows-driver-samples,166,0,10,modified,10,0,filesys/miniFilter/passThrough/README.md,low,1
Windows-driver-samples,166,0,10,modified,10,0,filesys/miniFilter/scanner/README.md,low,1
Windows-driver-samples,166,0,10,modified,10,0,filesys/miniFilter/simrep/README.md,low,1
Windows-driver-samples,166,0,10,modified,10,0,filesys/miniFilter/swapBuffers/README.md,low,1
Windows-driver-samples,166,0,10,modified,10,0,general/DCHU/README.md,low,0
Windows-driver-samples,166,0,10,modified,10,0,general/PLX9x5x/README.md,low,1
Windows-driver-samples,166,0,10,modified,10,0,general/SystemDma/wdm/README.md,low,1
Windows-driver-samples,166,0,10,modified,10,0,general/cancel/README.md,low,0
Windows-driver-samples,166,0,10,modified,10,0,general/echo/kmdf/README.md,low,0
Windows-driver-samples,165,1,73,modified,73,0,setup/devcon/cmds.cpp,high,0
Windows-driver-samples,165,1,21,modified,21,0,setup/devcon/msg.mc,high,0
Windows-driver-samples,164,4,19,modified,19,0,general/DCHU/osrfx2_DCHU_base/osrfx2_DCHU_base.sln,low,0
Windows-driver-samples,164,4,0,modified,0,0,general/DCHU/osrfx2_DCHU_base/osrfx2_DCHU_base/osrfx2_DCHU_base.inx,NaN,0
Windows-driver-samples,164,4,30,modified,25,5,general/DCHU/osrfx2_DCHU_base/osrfx2_DCHU_base/osrfx2_DCHU_base.vcxproj,medium,0
Windows-driver-samples,164,4,6,modified,3,3,general/DCHU/osrfx2_DCHU_base/osrfx2_DCHU_filter/osrfx2_DCHU_filter.vcxproj,medium,0
Windows-driver-samples,164,4,2,modified,1,1,general/DCHU/osrfx2_DCHU_base/osrfx2_DCHU_testapp/osrusbfx2.vcxproj,medium,0
Windows-driver-samples,164,4,0,renamed,0,0,general/DCHU/osrfx2_DCHU_base/osrfx2_DCHU_usersvc/CppWindowsService.cpp,high,0
Windows-driver-samples,164,4,1217,added,1217,0,general/DCHU/osrfx2_DCHU_base/osrfx2_DCHU_usersvc/Main.cpp,high,0
Windows-driver-samples,164,4,85,renamed,76,9,general/DCHU/osrfx2_DCHU_base/osrfx2_DCHU_usersvc/Main.h,high,0
Windows-driver-samples,164,4,24,renamed,12,12,general/DCHU/osrfx2_DCHU_base/osrfx2_DCHU_usersvc/SampleService.cpp,high,0
Windows-driver-samples,164,4,13,renamed,13,0,general/DCHU/osrfx2_DCHU_base/osrfx2_DCHU_usersvc/SampleService.h,high,0
Windows-driver-samples,164,4,0,renamed,0,0,general/DCHU/osrfx2_DCHU_base/osrfx2_DCHU_usersvc/ServiceBase.cpp,high,0
Windows-driver-samples,164,4,0,renamed,0,0,general/DCHU/osrfx2_DCHU_base/osrfx2_DCHU_usersvc/ServiceBase.h,high,0
Windows-driver-samples,164,4,0,renamed,0,0,general/DCHU/osrfx2_DCHU_base/osrfx2_DCHU_usersvc/ThreadPool.h,high,0
Windows-driver-samples,164,4,0,renamed,0,0,general/DCHU/osrfx2_DCHU_base/osrfx2_DCHU_usersvc/Utils.cpp,high,0
Windows-driver-samples,164,4,0,renamed,0,0,general/DCHU/osrfx2_DCHU_base/osrfx2_DCHU_usersvc/Utils.h,high,0
Windows-driver-samples,164,4,0,renamed,0,0,general/DCHU/osrfx2_DCHU_base/osrfx2_DCHU_usersvc/osrfx2_DCHU_usersvc.filters,medium,0
Windows-driver-samples,164,4,0,renamed,0,0,general/DCHU/osrfx2_DCHU_base/osrfx2_DCHU_usersvc/osrfx2_DCHU_usersvc.inx,NaN,0
Windows-driver-samples,164,4,20,renamed,10,10,general/DCHU/osrfx2_DCHU_base/osrfx2_DCHU_usersvc/osrfx2_DCHU_usersvc.vcxproj,medium,0
Windows-driver-samples,164,4,79,removed,0,79,general/DCHU/osrfx2_DCHU_extension/osrfx2_DCHU_extension/osrfx2_DCHU_extension.inx,NaN,0
Windows-driver-samples,164,4,320,removed,0,320,general/DCHU/osrfx2_DCHU_extension/osrfx2_DCHU_usersvc/Main.cpp,high,0
Windows-driver-samples,164,4,0,renamed,0,0,general/DCHU/osrfx2_DCHU_extension_loose/osrfx2_DCHU_component/osrfx2_DCHU_component.filters,medium,0
Windows-driver-samples,164,4,0,renamed,0,0,general/DCHU/osrfx2_DCHU_extension_loose/osrfx2_DCHU_component/osrfx2_DCHU_component.inx,NaN,0
Windows-driver-samples,164,4,4,renamed,4,0,general/DCHU/osrfx2_DCHU_extension_loose/osrfx2_DCHU_component/osrfx2_DCHU_component.vcxproj,medium,0
Windows-driver-samples,164,4,0,renamed,0,0,general/DCHU/osrfx2_DCHU_extension_loose/osrfx2_DCHU_componentsoftware/osrfx2_DCHU_componentsoftware.cpp,high,0
Windows-driver-samples,164,4,0,renamed,0,0,general/DCHU/osrfx2_DCHU_extension_loose/osrfx2_DCHU_componentsoftware/osrfx2_DCHU_componentsoftware.filters,medium,0
Windows-driver-samples,164,4,12,renamed,6,6,general/DCHU/osrfx2_DCHU_extension_loose/osrfx2_DCHU_componentsoftware/osrfx2_DCHU_componentsoftware.vcxproj,medium,0
Windows-driver-samples,164,4,0,renamed,0,0,general/DCHU/osrfx2_DCHU_extension_loose/osrfx2_DCHU_componentsoftware/stdafx.cpp,high,0
Windows-driver-samples,164,4,0,renamed,0,0,general/DCHU/osrfx2_DCHU_extension_loose/osrfx2_DCHU_componentsoftware/stdafx.h,high,0
Windows-driver-samples,164,4,0,renamed,0,0,general/DCHU/osrfx2_DCHU_extension_loose/osrfx2_DCHU_componentsoftware/targetver.h,high,0
Windows-driver-samples,164,4,41,renamed,35,6,general/DCHU/osrfx2_DCHU_extension_loose/osrfx2_DCHU_extension.sln,low,0
Windows-driver-samples,163,1,0,modified,0,0,general/toaster/toastDrv/kmdf/bus/static/statbus.inx,NaN,1
Windows-driver-samples,162,1,0,modified,0,0,general/toaster/toastDrv/kmdf/func/simple/wdfsimple.inx,NaN,1
Windows-driver-samples,161,1,0,modified,0,0,general/toaster/toastDrv/kmdf/func/featured/wdffeatured.inx,NaN,1
Windows-driver-samples,160,1,0,modified,0,0,general/toaster/toastDrv/kmdf/bus/dynamic/dynambus.inx,NaN,1
Windows-driver-samples,156,1,18,modified,0,18,general/DCHU/osrfx2_DCHU_base/osrfx2_DCHU_base.sln,low,0
Windows-driver-samples,156,1,0,modified,0,0,general/DCHU/osrfx2_DCHU_base/osrfx2_DCHU_base/osrfx2_DCHU_base.inx,NaN,0
Windows-driver-samples,156,1,17,modified,0,17,general/DCHU/osrfx2_DCHU_base/osrfx2_DCHU_base/osrfx2_DCHU_base.vcxproj,medium,0
Windows-driver-samples,156,1,2,modified,1,1,general/DCHU/osrfx2_DCHU_base/osrfx2_DCHU_base/osrusbfx2.h,high,0
Windows-driver-samples,156,1,2,modified,1,1,general/DCHU/osrfx2_DCHU_component/osrfx2_DCHU_component/osrfx2_DCHU_component.inx,NaN,0
Windows-driver-samples,156,1,11,modified,6,5,general/DCHU/osrfx2_DCHU_component/osrfx2_DCHU_componentsoftware/osrfx2_DCHU_componentsoftware.vcxproj,medium,0
Windows-driver-samples,156,1,25,modified,25,0,general/DCHU/osrfx2_DCHU_extension/osrfx2_DCHU_extension.sln,low,0
Windows-driver-samples,156,1,35,modified,33,2,general/DCHU/osrfx2_DCHU_extension/osrfx2_DCHU_extension/osrfx2_DCHU_extension.inx,NaN,0
Windows-driver-samples,156,1,23,modified,21,2,general/DCHU/osrfx2_DCHU_extension/osrfx2_DCHU_extension/osrfx2_DCHU_extension.vcxproj,medium,0
Windows-driver-samples,156,1,0,renamed,0,0,general/DCHU/osrfx2_DCHU_extension/osrfx2_DCHU_usersvc/CppWindowsService.cpp,high,0
Windows-driver-samples,156,1,0,renamed,0,0,general/DCHU/osrfx2_DCHU_extension/osrfx2_DCHU_usersvc/Main.cpp,high,0
Windows-driver-samples,156,1,0,renamed,0,0,general/DCHU/osrfx2_DCHU_extension/osrfx2_DCHU_usersvc/Main.h,high,0
Windows-driver-samples,156,1,0,renamed,0,0,general/DCHU/osrfx2_DCHU_extension/osrfx2_DCHU_usersvc/SampleService.cpp,high,0
Windows-driver-samples,156,1,0,renamed,0,0,general/DCHU/osrfx2_DCHU_extension/osrfx2_DCHU_usersvc/SampleService.h,high,0
Windows-driver-samples,156,1,0,renamed,0,0,general/DCHU/osrfx2_DCHU_extension/osrfx2_DCHU_usersvc/ServiceBase.cpp,high,0
Windows-driver-samples,156,1,0,renamed,0,0,general/DCHU/osrfx2_DCHU_extension/osrfx2_DCHU_usersvc/ServiceBase.h,high,0
Windows-driver-samples,156,1,0,renamed,0,0,general/DCHU/osrfx2_DCHU_extension/osrfx2_DCHU_usersvc/ThreadPool.h,high,0
Windows-driver-samples,156,1,0,renamed,0,0,general/DCHU/osrfx2_DCHU_extension/osrfx2_DCHU_usersvc/Utils.cpp,high,0
Windows-driver-samples,156,1,0,renamed,0,0,general/DCHU/osrfx2_DCHU_extension/osrfx2_DCHU_usersvc/Utils.h,high,0
Windows-driver-samples,156,1,0,renamed,0,0,general/DCHU/osrfx2_DCHU_extension/osrfx2_DCHU_usersvc/osrfx2_DCHU_usersvc.filters,medium,0
Windows-driver-samples,156,1,0,renamed,0,0,general/DCHU/osrfx2_DCHU_extension/osrfx2_DCHU_usersvc/osrfx2_DCHU_usersvc.inx,NaN,0
Windows-driver-samples,156,1,10,renamed,5,5,general/DCHU/osrfx2_DCHU_extension/osrfx2_DCHU_usersvc/osrfx2_DCHU_usersvc.vcxproj,medium,0
Windows-driver-samples,155,1,2,modified,1,1,usb/UcmCxUcsi/Ppm.h,high,0
Windows-driver-samples,155,1,2,modified,1,1,usb/UcmCxUcsi/Ucsi.h,high,0
Windows-driver-samples,153,1,10,modified,5,5,avstream/avshws/README.md,low,1
Windows-driver-samples,148,1,50,modified,25,25,audio/sysvad/EndpointsCommon/micarraywavtable.h,high,0
Windows-driver-samples,148,1,29,modified,23,6,audio/sysvad/ToneGenerator.cpp,high,0
Windows-driver-samples,147,3,3,modified,3,0,pos/drivers/MagneticStripeReader/Ioctl.cpp,high,0
Windows-driver-samples,147,3,3,modified,3,0,pos/drivers/barcodescanner/Ioctl.cpp,high,0
Windows-driver-samples,146,1,27,added,27,0,general/DCHU/README.md,low,0
Windows-driver-samples,146,1,43,removed,0,43,general/DCHU/README.txt,low,0
Windows-driver-samples,145,1,8,modified,4,4,audio/sysvad/KeywordDetectorAdapter/KeywordDetectorContosoAdapter.vcxproj,medium,0
Windows-driver-samples,145,1,3,modified,0,3,audio/sysvad/Package/package.VcxProj,NaN,0
Windows-driver-samples,145,1,8,modified,3,5,audio/sysvad/README.md,low,1
Windows-driver-samples,145,1,8,modified,4,4,audio/sysvad/SwapAPO/APO/SwapAPO.vcxproj,medium,0
Windows-driver-samples,145,1,21,modified,18,3,audio/sysvad/SwapAPO/APO/SwapAPO.vcxproj.Filters,NaN,0
Windows-driver-samples,145,1,8,modified,4,4,audio/sysvad/SwapAPO/DelayAPO/DelayAPO.vcxproj,medium,0
Windows-driver-samples,145,1,49,renamed,29,20,audio/sysvad/SwapAPO/DelayAPO/DelayAPO.vcxproj.Filters,NaN,0
Windows-driver-samples,145,1,1087,removed,0,1087,audio/sysvad/SwapAPO/PropPageExtensions/AdvEndpointPropPage.cpp,high,0
Windows-driver-samples,145,1,74,removed,0,74,audio/sysvad/SwapAPO/PropPageExtensions/AdvEndpointPropPage.h,high,0
Windows-driver-samples,145,1,27,removed,0,27,audio/sysvad/SwapAPO/PropPageExtensions/AdvEndpointPropPage.rgs,NaN,0
Windows-driver-samples,145,1,73,removed,0,73,audio/sysvad/SwapAPO/PropPageExtensions/CplExt.cpp,high,0
Windows-driver-samples,145,1,73,removed,0,73,audio/sysvad/SwapAPO/PropPageExtensions/CplExt.idl,high,0
Windows-driver-samples,145,1,208,removed,0,208,audio/sysvad/SwapAPO/PropPageExtensions/CplExt.rc,low,0
Windows-driver-samples,145,1,11,removed,0,11,audio/sysvad/SwapAPO/PropPageExtensions/CplExt.rgs,NaN,0
Windows-driver-samples,145,1,298,removed,0,298,audio/sysvad/SwapAPO/PropPageExtensions/Parts.cpp,high,0
Windows-driver-samples,145,1,49,removed,0,49,audio/sysvad/SwapAPO/PropPageExtensions/Parts.h,high,0
Windows-driver-samples,145,1,9,removed,0,9,audio/sysvad/SwapAPO/PropPageExtensions/PropPageExt.def,low,0
Windows-driver-samples,145,1,275,removed,0,275,audio/sysvad/SwapAPO/PropPageExtensions/PropPageExt.vcxproj,medium,0
Windows-driver-samples,145,1,1154,removed,0,1154,audio/sysvad/SwapAPO/PropPageExtensions/SwapPropPage.cpp,high,0
Windows-driver-samples,145,1,92,removed,0,92,audio/sysvad/SwapAPO/PropPageExtensions/SwapPropPage.h,high,0
Windows-driver-samples,145,1,27,removed,0,27,audio/sysvad/SwapAPO/PropPageExtensions/SwapPropPage.rgs,NaN,0
Windows-driver-samples,145,1,162,removed,0,162,audio/sysvad/SwapAPO/PropPageExtensions/TopologyExaminers.cpp,high,0
Windows-driver-samples,145,1,50,removed,0,50,audio/sysvad/SwapAPO/PropPageExtensions/TopologyExaminers.h,high,0
Windows-driver-samples,145,1,321,removed,0,321,audio/sysvad/SwapAPO/PropPageExtensions/UIWidgets.cpp,high,0
Windows-driver-samples,145,1,405,removed,0,405,audio/sysvad/SwapAPO/PropPageExtensions/UIWidgets.h,high,0
Windows-driver-samples,145,1,36,removed,0,36,audio/sysvad/SwapAPO/PropPageExtensions/makefile,NaN,0
Windows-driver-samples,145,1,0,removed,0,0,audio/sysvad/SwapAPO/PropPageExtensions/music.ico,low,0
Windows-driver-samples,145,1,34,removed,0,34,audio/sysvad/SwapAPO/PropPageExtensions/resource.h,high,0
Windows-driver-samples,145,1,60,removed,0,60,audio/sysvad/SwapAPO/PropPageExtensions/sources,NaN,0
Windows-driver-samples,145,1,18,removed,0,18,audio/sysvad/SwapAPO/PropPageExtensions/stdafx.cpp,high,0
Windows-driver-samples,139,3,297,added,297,0,audio/sysvad/EndpointsCommon/AudioModule0.h,high,0
Windows-driver-samples,139,3,312,added,312,0,audio/sysvad/EndpointsCommon/AudioModule1.h,high,0
Windows-driver-samples,139,3,296,added,296,0,audio/sysvad/EndpointsCommon/AudioModule2.h,high,0
Windows-driver-samples,139,3,644,added,644,0,audio/sysvad/EndpointsCommon/AudioModuleHelper.cpp,high,0
Windows-driver-samples,139,3,95,added,95,0,audio/sysvad/EndpointsCommon/AudioModuleHelper.h,high,0
Windows-driver-samples,139,3,1,modified,1,0,audio/sysvad/EndpointsCommon/EndpointsCommon.vcxproj,medium,0
Windows-driver-samples,139,3,62,added,62,0,audio/sysvad/EndpointsCommon/EndpointsCommon.vcxproj.Filters,NaN,0
Windows-driver-samples,139,3,1,modified,1,0,audio/sysvad/EndpointsCommon/MiniportStreamAudioEngineNode.cpp,high,0
Windows-driver-samples,139,3,427,modified,425,2,audio/sysvad/EndpointsCommon/minwavert.cpp,high,0
Windows-driver-samples,139,3,86,modified,84,2,audio/sysvad/EndpointsCommon/minwavert.h,high,0
Windows-driver-samples,139,3,75,modified,71,4,audio/sysvad/EndpointsCommon/minwavertstream.cpp,high,0
Windows-driver-samples,139,3,37,modified,37,0,audio/sysvad/EndpointsCommon/minwavertstream.h,high,0
Windows-driver-samples,139,3,46,added,46,0,audio/sysvad/EndpointsCommon/sources,NaN,0
Windows-driver-samples,139,3,127,modified,125,2,audio/sysvad/EndpointsCommon/speakerhpwavtable.h,high,0
Windows-driver-samples,139,3,126,modified,124,2,audio/sysvad/EndpointsCommon/speakerwavtable.h,high,0
Windows-driver-samples,139,3,16,modified,8,8,audio/sysvad/KeywordDetectorAdapter/KeywordDetectorContosoAdapter.vcxproj,medium,0
Windows-driver-samples,139,3,39,added,39,0,audio/sysvad/KeywordDetectorAdapter/KeywordDetectorContosoAdapter.vcxproj.Filters,NaN,0
Windows-driver-samples,139,3,53,added,53,0,audio/sysvad/KeywordDetectorAdapter/sources,NaN,0
Windows-driver-samples,139,3,99,added,99,0,audio/sysvad/Package/package.VcxProj,NaN,0
Windows-driver-samples,139,3,21,added,21,0,audio/sysvad/Package/package.VcxProj.Filters,NaN,0
Windows-driver-samples,139,3,73,added,73,0,audio/sysvad/PhoneAudioSample/PhoneAudioSample.vcxproj.Filters,NaN,0
Windows-driver-samples,139,3,29,modified,20,9,audio/sysvad/PhoneAudioSample/minipairs.h,high,0
Windows-driver-samples,139,3,58,added,58,0,audio/sysvad/PhoneAudioSample/sources,NaN,0
Windows-driver-samples,139,3,30,modified,16,14,audio/sysvad/README.md,low,1
Windows-driver-samples,139,3,37,modified,0,37,audio/sysvad/SwapAPO/APO/SwapAPO.h,high,0
Windows-driver-samples,139,3,8,modified,4,4,audio/sysvad/SwapAPO/APO/SwapAPO.vcxproj,medium,0
Windows-driver-samples,139,3,45,added,45,0,audio/sysvad/SwapAPO/APO/SwapAPO.vcxproj.Filters,NaN,0
Windows-driver-samples,139,3,36,added,36,0,audio/sysvad/SwapAPO/APO/makefile,NaN,0
Windows-driver-samples,139,3,13,added,13,0,audio/sysvad/SwapAPO/APO/sources,NaN,0
Windows-driver-samples,139,3,69,modified,0,69,audio/sysvad/SwapAPO/APO/swap.cpp,high,0
Windows-driver-samples,138,6,2914,added,2914,0,audio/sysvad/BthhfpDevice.cpp,high,1
Windows-driver-samples,138,6,404,added,404,0,audio/sysvad/BthhfpDevice.h,high,1
Windows-driver-samples,138,6,301,added,301,0,audio/sysvad/EndpointsCommon/AudioModule0.h,high,1
Windows-driver-samples,138,6,316,added,316,0,audio/sysvad/EndpointsCommon/AudioModule1.h,high,1
Windows-driver-samples,138,6,300,added,300,0,audio/sysvad/EndpointsCommon/AudioModule2.h,high,1
Windows-driver-samples,138,6,644,added,644,0,audio/sysvad/EndpointsCommon/AudioModuleHelper.cpp,high,1
Windows-driver-samples,138,6,103,added,103,0,audio/sysvad/EndpointsCommon/AudioModuleHelper.h,high,1
Windows-driver-samples,138,6,5,modified,5,0,audio/sysvad/EndpointsCommon/EndpointsCommon.vcxproj,medium,1
Windows-driver-samples,138,6,62,added,62,0,audio/sysvad/EndpointsCommon/EndpointsCommon.vcxproj.Filters,NaN,1
Windows-driver-samples,138,6,30,modified,18,12,audio/sysvad/EndpointsCommon/MiniportStreamAudioEngineNode.cpp,high,1
Windows-driver-samples,138,6,7,modified,4,3,audio/sysvad/EndpointsCommon/bthhfpmictopo.cpp,high,1
Windows-driver-samples,138,6,9,modified,5,4,audio/sysvad/EndpointsCommon/bthhfpminwavert.cpp,high,1
Windows-driver-samples,138,6,7,modified,4,3,audio/sysvad/EndpointsCommon/bthhfpspeakertopo.cpp,high,1
Windows-driver-samples,138,6,23,modified,12,11,audio/sysvad/EndpointsCommon/bthhfptopo.cpp,high,1
Windows-driver-samples,138,6,58,modified,28,30,audio/sysvad/EndpointsCommon/mintopo.cpp,high,1
Windows-driver-samples,138,6,60,modified,42,18,audio/sysvad/EndpointsCommon/mintopo.h,high,1
Windows-driver-samples,138,6,436,modified,430,6,audio/sysvad/EndpointsCommon/minwavert.cpp,high,1
Windows-driver-samples,138,6,138,modified,117,21,audio/sysvad/EndpointsCommon/minwavert.h,high,1
Windows-driver-samples,138,6,311,modified,237,74,audio/sysvad/EndpointsCommon/minwavertstream.cpp,high,1
Windows-driver-samples,138,6,58,modified,52,6,audio/sysvad/EndpointsCommon/minwavertstream.h,high,1
Windows-driver-samples,138,6,48,added,48,0,audio/sysvad/EndpointsCommon/sources,NaN,1
Windows-driver-samples,138,6,127,modified,125,2,audio/sysvad/EndpointsCommon/speakerhpwavtable.h,high,1
Windows-driver-samples,138,6,126,modified,124,2,audio/sysvad/EndpointsCommon/speakerwavtable.h,high,1
Windows-driver-samples,138,6,267,added,267,0,audio/sysvad/EndpointsCommon/usbhsmictopo.cpp,high,1
Windows-driver-samples,138,6,40,added,40,0,audio/sysvad/EndpointsCommon/usbhsmictopo.h,high,1
Windows-driver-samples,138,6,290,added,290,0,audio/sysvad/EndpointsCommon/usbhsmictoptable.h,high,1
Windows-driver-samples,138,6,452,added,452,0,audio/sysvad/EndpointsCommon/usbhsmicwavtable.h,high,1
Windows-driver-samples,138,6,180,added,180,0,audio/sysvad/EndpointsCommon/usbhsminipairs.h,high,1
Windows-driver-samples,138,6,200,added,200,0,audio/sysvad/EndpointsCommon/usbhsminwavert.cpp,high,1
Windows-driver-samples,138,6,267,added,267,0,audio/sysvad/EndpointsCommon/usbhsspeakertopo.cpp,high,1
Windows-driver-samples,136,1,4,modified,2,2,usb/kmdf_fx2/driver/Device.c,high,0
Windows-driver-samples,136,1,0,modified,0,0,usb/kmdf_fx2/driver/osrusbfx2.inx,NaN,0
Windows-driver-samples,136,1,0,modified,0,0,usb/umdf2_fx2/driver/osrusbfx2um.inx,NaN,0
Windows-driver-samples,129,1,3,modified,1,2,setup/devcon/dump.cpp,high,0
Windows-driver-samples,128,1,431,added,431,0,avstream/SensorDeviceDMFT/Common.h,high,1
Windows-driver-samples,128,1,251,added,251,0,avstream/SensorDeviceDMFT/DllMain.cpp,high,1
Windows-driver-samples,128,1,7,added,7,0,avstream/SensorDeviceDMFT/SensorDeviceMFT.def,low,1
Windows-driver-samples,128,1,181,added,181,0,avstream/SensorDeviceDMFT/SensorDeviceMFT.vcxproj,medium,1
Windows-driver-samples,128,1,59,added,59,0,avstream/SensorDeviceDMFT/SensorDeviceMFT.vcxproj.filters,medium,1
Windows-driver-samples,128,1,1349,added,1349,0,avstream/SensorDeviceDMFT/SensorTransformSampleMFT.cpp,high,1
Windows-driver-samples,128,1,151,added,151,0,avstream/SensorDeviceDMFT/SensorTransformSampleMFT.h,high,1
Windows-driver-samples,128,1,718,added,718,0,avstream/SensorDeviceDMFT/SensorTransformSampleMFTPin.cpp,high,1
Windows-driver-samples,128,1,114,added,114,0,avstream/SensorDeviceDMFT/SensorTransformSampleMFTPin.h,high,1
Windows-driver-samples,128,1,175,added,175,0,avstream/SensorDeviceDMFT/SensorTransformSampleMFTUtils.cpp,high,1
Windows-driver-samples,128,1,1,added,1,0,avstream/SensorDeviceDMFT/stdafx.cpp,high,1
Windows-driver-samples,128,1,65,added,65,0,avstream/SensorDeviceDMFT/stdafx.h,high,1
Windows-driver-samples,125,2,8,modified,4,4,audio/sysvad/SwapAPO/APO/SwapAPO.vcxproj,medium,0
Windows-driver-samples,124,2,0,renamed,0,0,avstream/avscamera/Package/package.VcxProj,NaN,0
Windows-driver-samples,124,2,0,renamed,0,0,avstream/avscamera/Package/package.VcxProj.Filters,NaN,0
Windows-driver-samples,124,2,0,renamed,0,0,avstream/avscamera/README.md,low,1
Windows-driver-samples,124,2,0,renamed,0,0,avstream/avscamera/avscamera.sln,low,0
Windows-driver-samples,124,2,0,renamed,0,0,avstream/avscamera/mft0/AvsCameraMFT0.rc,low,0
Windows-driver-samples,124,2,0,renamed,0,0,avstream/avscamera/mft0/AvsCameraMft0.vcxproj,medium,0
Windows-driver-samples,124,2,0,renamed,0,0,avstream/avscamera/mft0/AvsCameraMft0.vcxproj.Filters,NaN,0
Windows-driver-samples,124,2,0,renamed,0,0,avstream/avscamera/sys/AvsCamera.rc,low,0
Windows-driver-samples,124,2,0,renamed,0,0,avstream/avscamera/sys/AvsCamera.vcxproj,medium,0
Windows-driver-samples,124,2,0,renamed,0,0,avstream/avscamera/sys/AvsCamera.vcxproj.Filters,NaN,0
Windows-driver-samples,120,1,0,modified,0,0,usb/kmdf_fx2/driver/osrusbfx2.inx,NaN,0
Windows-driver-samples,120,1,2,modified,1,1,usb/kmdf_fx2/driver/osrusbfx2.vcxproj,medium,0
Windows-driver-samples,120,1,31,modified,31,0,usb/umdf2_fx2/driver/Device.c,high,0
Windows-driver-samples,120,1,0,modified,0,0,usb/umdf2_fx2/driver/osrusbfx2um.inx,NaN,0
Windows-driver-samples,120,1,2,modified,1,1,usb/umdf2_fx2/driver/osrusbfx2um.vcxproj,medium,0
Windows-driver-samples,114,8,2,modified,2,0,.gitignore,low,0
Windows-driver-samples,114,8,4,modified,4,0,audio/sysvad/EndpointsCommon/EndpointsCommon.vcxproj,medium,1
Windows-driver-samples,114,8,18,modified,9,9,audio/sysvad/KeywordDetectorAdapter/KeywordDetectorContosoAdapter.vcxproj,medium,0
Windows-driver-samples,114,8,6,modified,4,2,audio/sysvad/KeywordDetectorAdapter/dllmain.cpp,high,0
Windows-driver-samples,114,8,6,modified,5,1,audio/sysvad/PhoneAudioSample/PhoneAudioSample.vcxproj,medium,0
Windows-driver-samples,114,8,8,modified,8,0,audio/sysvad/SwapAPO/APO/SwapAPO.vcxproj,medium,0
Windows-driver-samples,114,8,6,modified,5,1,audio/sysvad/TabletAudioSample/TabletAudioSample.vcxproj,medium,0
Windows-driver-samples,90,0,182,added,182,0,audio/sysvad/EndpointsCommon/EndpointsCommon.vcxproj,medium,1
Windows-driver-samples,90,0,232,added,232,0,audio/sysvad/KeywordDetectorAdapter/KeywordDetectorContosoAdapter.vcxproj,medium,0
Windows-driver-samples,90,0,300,added,300,0,audio/sysvad/PhoneAudioSample/PhoneAudioSample.vcxproj,medium,0
Windows-driver-samples,90,0,242,added,242,0,audio/sysvad/SwapAPO/APO/SwapAPO.vcxproj,medium,0
Windows-driver-samples,90,0,275,added,275,0,audio/sysvad/SwapAPO/PropPageExtensions/PropPageExt.vcxproj,medium,0
Windows-driver-samples,90,0,295,added,295,0,audio/sysvad/TabletAudioSample/TabletAudioSample.vcxproj,medium,0
Windows-driver-samples,90,0,164,modified,82,82,audio/sysvad/sysvad.sln,low,0
Windows-driver-samples,86,5,171,modified,170,1,usb/UcmTcpciCxClientSample/README.md,low,0
Windows-driver-samples,85,1,329,added,329,0,usb/UcmTcpciCxClientSample/Alert.cpp,high,0
Windows-driver-samples,85,1,68,added,68,0,usb/UcmTcpciCxClientSample/Alert.h,high,0
Windows-driver-samples,85,1,335,added,335,0,usb/UcmTcpciCxClientSample/Device.cpp,high,0
Windows-driver-samples,85,1,106,added,106,0,usb/UcmTcpciCxClientSample/Device.h,high,0
Windows-driver-samples,85,1,161,added,161,0,usb/UcmTcpciCxClientSample/Driver.cpp,high,0
Windows-driver-samples,85,1,45,added,45,0,usb/UcmTcpciCxClientSample/Driver.h,high,0
Windows-driver-samples,85,1,1048,added,1048,0,usb/UcmTcpciCxClientSample/I2C.cpp,high,0
Windows-driver-samples,85,1,126,added,126,0,usb/UcmTcpciCxClientSample/I2C.h,high,0
Windows-driver-samples,85,1,604,added,604,0,usb/UcmTcpciCxClientSample/PortControllerInterface.cpp,high,0
Windows-driver-samples,85,1,73,added,73,0,usb/UcmTcpciCxClientSample/PortControllerInterface.h,high,0
Windows-driver-samples,85,1,230,added,230,0,usb/UcmTcpciCxClientSample/Queue.cpp,high,0
Windows-driver-samples,85,1,30,added,30,0,usb/UcmTcpciCxClientSample/Queue.h,high,0
Windows-driver-samples,85,1,28,added,28,0,usb/UcmTcpciCxClientSample/README.md,low,0
Windows-driver-samples,85,1,79,added,79,0,usb/UcmTcpciCxClientSample/Register.h,high,0
Windows-driver-samples,85,1,142,added,142,0,usb/UcmTcpciCxClientSample/Sample.asl,NaN,0
Windows-driver-samples,85,1,61,added,61,0,usb/UcmTcpciCxClientSample/Trace.h,high,0
Windows-driver-samples,85,1,0,added,0,0,usb/UcmTcpciCxClientSample/UcmTcpciCxClientSample.inf,NaN,0
Windows-driver-samples,85,1,40,added,40,0,usb/UcmTcpciCxClientSample/UcmTcpciCxClientSample.sln,low,0
Windows-driver-samples,85,1,186,added,186,0,usb/UcmTcpciCxClientSample/UcmTcpciCxClientSample.vcxproj,medium,0
Windows-driver-samples,85,1,72,added,72,0,usb/UcmTcpciCxClientSample/UcmTcpciCxClientSample.vcxproj.Filters,NaN,0
Windows-driver-samples,85,1,8,added,8,0,usb/UcmTcpciCxClientSample/makefile,NaN,0
Windows-driver-samples,85,1,9,added,9,0,usb/UcmTcpciCxClientSample/resource.rc,low,0
Windows-driver-samples,83,0,2,modified,1,1,filesys/miniFilter/avscan/filter/avscan.c,high,0
Windows-driver-samples,83,0,2,modified,1,1,filesys/miniFilter/change/change.c,high,0
Windows-driver-samples,82,0,6,modified,3,3,filesys/miniFilter/avscan/filter/avscan.c,high,0
Windows-driver-samples,82,0,1,modified,1,0,filesys/miniFilter/avscan/filter/utility.c,high,0
Windows-driver-samples,81,1,3,modified,3,0,usb/usbview/usbschema.hpp,NaN,0
Windows-driver-samples,80,1,15,modified,11,4,usb/usbview/display.c,high,0
Windows-driver-samples,78,1,2,modified,1,1,README.md,low,1
Windows-driver-samples,68,5,2,modified,2,0,.gitignore,low,1
Windows-driver-samples,68,5,5,modified,5,0,audio/sysvad/EndpointsCommon/EndpointsCommon.vcxproj,medium,2
Windows-driver-samples,68,5,583,modified,583,0,audio/sysvad/EndpointsCommon/EndpointsCommon.vcxproj.Filters,NaN,2
Windows-driver-samples,68,5,30,added,30,0,audio/sysvad/EndpointsCommon/HwSimClock.cpp,high,1
Windows-driver-samples,68,5,24,added,24,0,audio/sysvad/EndpointsCommon/HwSimClock.h,high,1
Windows-driver-samples,68,5,4,modified,4,0,audio/sysvad/PhoneAudioSample/PhoneAudioSample.vcxproj,medium,1
Windows-driver-samples,68,5,4,modified,4,0,audio/sysvad/TabletAudioSample/TabletAudioSample.vcxproj,medium,1
Windows-driver-samples,53,1,75,modified,72,3,storage/ramdisk/src/ramdisk.c,high,0
Windows-driver-samples,53,1,1,modified,1,0,storage/ramdisk/src/ramdisk.h,high,0
Windows-driver-samples,51,2,1,modified,0,1,hid/hclient/ecdisp.c,high,1
Windows-driver-samples,51,2,19,modified,12,7,hid/hclient/hclient.c,high,1
Windows-driver-samples,51,2,3,modified,2,1,hid/hclient/hid.h,high,1
Windows-driver-samples,51,2,10,modified,5,5,hid/hclient/report.c,high,1
nvm-windows,387,1,3,modified,3,0,.gitattributes,low,0
nvm-windows,377,1,9,added,9,0,.editorconfig,medium,1
nvm-windows,372,1,2,modified,1,1,README.md,low,0
nvm-windows,370,1,5,modified,3,2,src/nvm.go,high,1
nvm-windows,358,3,14,modified,14,0,README.md,low,0
nvm-windows,354,2,11,modified,8,3,bin/install.cmd,medium,0
nvm-windows,347,1,1,modified,1,0,.github/ISSUE_TEMPLATE,NaN,1
nvm-windows,347,1,2,modified,1,1,build.bat,medium,1
nvm-windows,347,1,2,modified,1,1,nvm.iss,medium,1
nvm-windows,347,1,2,modified,1,1,src/nvm.go,high,2
nvm-windows,346,3,62,modified,21,41,nvm.iss,medium,1
nvm-windows,341,1,12,modified,6,6,README.md,low,0
nvm-windows,338,1,1,modified,1,0,README.md,low,0
nvm-windows,331,2,25,modified,19,6,src/nvm.go,high,2
nvm-windows,328,3,1,modified,1,0,README.md,low,0
nvm-windows,328,3,2,modified,2,0,examples/settings.txt,low,0
nvm-windows,308,2,4,modified,2,2,README.md,low,1
nvm-windows,306,2,2,modified,1,1,README.md,low,1
nvm-windows,286,2,20,modified,17,3,src/nvm.go,high,3
nvm-windows,269,1,19,modified,13,6,src/nvm.go,high,3
nvm-windows,264,2,10,modified,5,5,nvm.iss,medium,1
nvm-windows,263,0,6,modified,3,3,README.md,low,2
nvm-windows,263,0,10,modified,5,5,build.bat,medium,2
nvm-windows,263,0,2,modified,1,1,nvm.iss,medium,2
nvm-windows,261,1,2,modified,1,1,README.md,low,2
nvm-windows,258,0,2,modified,2,0,.gitignore,low,1
nvm-windows,257,1,3,modified,2,1,build.bat,medium,2
nvm-windows,253,1,3,modified,3,0,src/nvm/arch/arch.go,high,2
nvm-windows,251,4,2,modified,2,0,README.md,low,2
nvm-windows,251,4,2,modified,1,1,nvm.iss,medium,2
nvm-windows,251,4,16,modified,14,2,src/nvm.go,high,5
nvm-windows,251,4,32,modified,25,7,src/nvm/web/web.go,high,2
nvm-windows,237,0,44,modified,43,1,src/nvm.go,high,6
nvm-windows,237,0,10,modified,8,2,src/nvm/web/web.go,high,3
nvm-windows,234,5,0,added,0,0,images/EnvVars.png,low,1
nvm-windows,234,5,0,added,0,0,images/installer.jpg,low,1
nvm-windows,234,5,0,added,0,0,images/installlatest.jpg,low,1
nvm-windows,234,5,0,added,0,0,images/use.jpg,low,1
nvm-windows,234,5,11,added,11,0,index.html,medium,1
nvm-windows,233,3,144,modified,83,61,src/nvm.go,high,6
nvm-windows,233,3,19,modified,14,5,src/nvm/node/node.go,high,1
nvm-windows,233,3,16,modified,8,8,src/nvm/web/web.go,high,3
nvm-windows,232,0,9,modified,6,3,README.md,low,2
nvm-windows,231,0,2,modified,1,1,nvm.iss,medium,3
nvm-windows,231,0,2,modified,1,1,src/nvm/node/node.go,high,2
nvm-windows,228,2,4,modified,2,2,src/nvm.go,high,7
nvm-windows,226,2,1102,modified,567,535,src/nvm.go,high,8
nvm-windows,226,2,102,modified,51,51,src/nvm/arch/arch.go,high,3
nvm-windows,226,2,114,modified,57,57,src/nvm/file/file.go,high,2
nvm-windows,226,2,309,modified,160,149,src/nvm/node/node.go,high,3
nvm-windows,226,2,578,modified,289,289,src/nvm/semver/semver.go,high,1
nvm-windows,226,2,325,modified,163,162,src/nvm/web/web.go,high,4
nvm-windows,225,1,1080,modified,545,535,src/nvm.go,high,9
nvm-windows,225,1,102,modified,51,51,src/nvm/arch/arch.go,high,4
nvm-windows,225,1,114,modified,57,57,src/nvm/file/file.go,high,3
nvm-windows,225,1,300,modified,151,149,src/nvm/node/node.go,high,4
nvm-windows,225,1,578,modified,289,289,src/nvm/semver/semver.go,high,2
nvm-windows,225,1,325,modified,163,162,src/nvm/web/web.go,high,5
nvm-windows,222,1,17,modified,16,1,src/nvm.go,high,9
nvm-windows,218,1,30,modified,16,14,src/nvm.go,high,9
nvm-windows,217,2,22,modified,11,11,build.bat,medium,3
nvm-windows,217,2,5,modified,4,1,nvm.iss,medium,4
nvm-windows,209,0,2,modified,2,0,README.md,low,3
nvm-windows,209,0,4,modified,2,2,src/nvm.go,high,10
nvm-windows,206,1,4,modified,2,2,src/nvm.go,high,10
nvm-windows,205,1,30,modified,16,14,src/nvm.go,high,10
nvm-windows,204,1,1,modified,1,0,.gitignore,low,2
nvm-windows,204,1,14,modified,14,0,build.bat,medium,4
nvm-windows,204,1,587,modified,271,316,nvm.iss,medium,5
nvm-windows,204,1,316,added,316,0,nvm.iss.template,low,1
nvm-windows,194,0,2,modified,1,1,nvm.iss,medium,6
nvm-windows,192,0,12,modified,6,6,README.md,low,3
nvm-windows,189,2,2,modified,2,0,.gitignore,low,3
nvm-windows,189,2,2,modified,1,1,src/nvm.go,high,11
nvm-windows,174,1,4,modified,2,2,README.md,low,3
nvm-windows,173,0,1125,modified,567,558,src/nvm.go,high,12
nvm-windows,173,0,102,modified,51,51,src/nvm/arch/arch.go,high,5
nvm-windows,173,0,114,modified,57,57,src/nvm/file/file.go,high,4
nvm-windows,173,0,213,modified,107,106,src/nvm/node/node.go,high,5
nvm-windows,173,0,578,modified,289,289,src/nvm/semver/semver.go,high,3
nvm-windows,173,0,324,modified,162,162,src/nvm/web/web.go,high,6
nvm-windows,165,1,7,modified,7,0,README.md,low,3
nvm-windows,162,1,41,modified,19,22,src/nvm.go,high,12
nvm-windows,162,1,52,modified,25,27,src/nvm/node/node.go,high,5
nvm-windows,160,3,22,modified,18,4,src/nvm.go,high,12
nvm-windows,160,3,5,modified,2,3,src/nvm/node/node.go,high,5
nvm-windows,160,3,39,modified,31,8,src/nvm/web/web.go,high,6
nvm-windows,143,1,2,modified,1,1,README.md,low,3
nvm-windows,139,1,2,modified,1,1,nvm.iss,medium,6
nvm-windows,132,1,3,modified,1,2,CONTRIBUTING.md,low,0
nvm-windows,94,3,2,modified,1,1,nvm.iss,medium,6
nvm-windows,94,3,22,modified,11,11,src/nvm.go,high,12
nvm-windows,94,3,26,modified,15,11,src/nvm/node/node.go,high,5
nvm-windows,94,3,60,modified,43,17,src/nvm/web/web.go,high,6
nvm-windows,86,2,1079,modified,532,547,src/nvm.go,high,13
nvm-windows,86,2,33,modified,17,16,src/nvm/node/node.go,high,6
nvm-windows,86,2,62,modified,56,6,src/nvm/web/web.go,high,7
nvm-windows,78,6,2,modified,1,1,README.md,low,4
nvm-windows,78,6,55,modified,32,23,build.bat,medium,5
nvm-windows,78,6,9,modified,4,5,nvm.iss,medium,7
nvm-windows,78,6,1105,modified,558,547,src/nvm.go,high,14
nvm-windows,78,6,102,modified,51,51,src/nvm/arch/arch.go,high,6
nvm-windows,78,6,114,modified,57,57,src/nvm/file/file.go,high,5
nvm-windows,78,6,208,modified,105,103,src/nvm/node/node.go,high,7
nvm-windows,78,6,578,modified,289,289,src/nvm/semver/semver.go,high,4
nvm-windows,78,6,246,modified,123,123,src/nvm/web/web.go,high,8
nvm-windows,77,1,12,modified,11,1,src/nvm/node/node.go,high,7
nvm-windows,51,1,18,modified,11,7,src/nvm.go,high,14
nvm-windows,51,1,17,modified,15,2,src/nvm/web/web.go,high,8
nvm-windows,48,1,54,modified,43,11,src/nvm/arch/arch.go,high,6
nvm-windows,45,4,20,modified,19,1,src/nvm.go,high,14
nvm-windows,28,1,2,modified,2,0,README.md,low,4
cmder,1905,1,11,modified,10,1,vendor/init.bat,medium,0
cmder,1889,1,6,modified,3,3,vendor/init.bat,medium,0
cmder,1887,1,4,modified,2,2,vendor/init.bat,medium,0
cmder,1884,3,56,modified,32,24,vendor/clink.lua,NaN,0
cmder,1884,3,19,modified,15,4,vendor/init.bat,medium,0
cmder,1884,3,14,modified,8,6,vendor/lib/lib_git.cmd,medium,0
cmder,1884,3,18,modified,11,7,vendor/lib/lib_path.cmd,medium,0
cmder,1873,4,2,modified,1,1,launcher/CmderLauncher.sln,low,0
cmder,1873,4,9,modified,5,4,launcher/CmderLauncher.vcxproj,medium,0
cmder,1873,4,41,modified,40,1,launcher/src/CmderLauncher.cpp,high,0
cmder,1873,4,0,modified,0,0,launcher/src/resource.h,high,0
cmder,1873,4,1,renamed,1,0,launcher/src/resource.rc,low,0
cmder,1873,4,12,added,12,0,launcher/src/strings.rc2,high,0
cmder,1871,28,4,modified,4,0,.gitignore,low,0
cmder,1871,28,56,modified,53,3,launcher/src/CmderLauncher.cpp,high,0
cmder,1871,28,8,renamed,4,4,vendor/bin/alias.cmd,medium,0
cmder,1871,28,24,modified,24,0,vendor/clink.lua,NaN,0
cmder,1871,28,157,modified,91,66,vendor/init.bat,medium,0
cmder,1871,28,31,modified,31,0,vendor/lib/lib_base.cmd,medium,0
cmder,1871,28,18,modified,9,9,vendor/lib/lib_console.cmd,medium,0
cmder,1871,28,14,modified,7,7,vendor/lib/lib_git.cmd,medium,0
cmder,1871,28,32,modified,16,16,vendor/lib/lib_path.cmd,medium,0
cmder,1871,28,2,modified,1,1,vendor/lib/lib_profile.cmd,medium,0
cmder,1871,28,0,renamed,0,0,vendor/user_aliases.cmd.example,medium,0
cmder,1870,7,2,modified,2,0,.gitignore,low,0
cmder,1870,7,22,modified,11,11,README.md,low,0
cmder,1870,7,33,modified,32,1,launcher/src/CmderLauncher.cpp,high,0
cmder,1870,7,31,modified,21,10,vendor/cmder.sh,high,0
cmder,1870,7,58,modified,34,24,vendor/cmder_exinit,NaN,0
cmder,1870,7,14,modified,7,7,vendor/init.bat,medium,0
cmder,1870,7,18,modified,13,5,vendor/profile.ps1,high,0
cmder,1866,1,2,modified,1,1,launcher/src/CmderLauncher.cpp,high,0
cmder,1865,2,4,modified,2,2,config/ConEmu.xml,medium,0
cmder,1865,2,8,modified,4,4,vendor/profile.ps1,high,0
cmder,1864,1,4,modified,2,2,README.md,low,0
cmder,1860,1,5,modified,4,1,vendor/init.bat,medium,0
cmder,1834,1,51,modified,30,21,vendor/clink.lua,NaN,0
cmder,1805,1,2,modified,1,1,README.md,low,0
cmder,1796,4,8,modified,4,4,vendor/profile.ps1,high,0
cmder,1794,5,7,modified,2,5,vendor/lib/lib_base.cmd,medium,0
cmder,1794,5,4,modified,2,2,vendor/lib/lib_console.cmd,medium,0
cmder,1794,5,4,modified,2,2,vendor/lib/lib_git.cmd,medium,0
cmder,1794,5,4,modified,2,2,vendor/lib/lib_path.cmd,medium,0
cmder,1794,5,4,modified,2,2,vendor/lib/lib_profile.cmd,medium,0
cmder,1793,1,104,modified,52,52,README.md,low,0
cmder,1790,0,2,modified,1,1,vendor/clink.lua,NaN,1
cmder,1786,1,15,modified,11,4,vendor/init.bat,medium,0
cmder,1772,0,20,modified,19,1,launcher/src/CmderLauncher.cpp,high,1
cmder,1761,17,1,modified,1,0,.gitignore,low,0
cmder,1761,17,39,modified,39,0,README.md,low,0
cmder,1761,17,2,added,2,0,bin/add-cmderplugin.bat,medium,0
cmder,1761,17,204,added,204,0,bin/add-cmderplugin.ps1,high,0
cmder,1761,17,6,modified,5,1,scripts/build.ps1,high,0
cmder,1761,17,2,modified,1,1,scripts/utils.ps1,high,0
cmder,1761,17,37,added,37,0,vendor/cmder-plugin-atom.json,medium,0
cmder,1760,1,2,modified,2,0,scripts/utils.ps1,high,0
cmder,1758,28,76,modified,63,13,README.md,low,0
cmder,1758,28,135,added,135,0,vendor/bin/cexec.cmd,medium,0
cmder,1758,28,13,modified,11,2,vendor/init.bat,medium,0
cmder,1758,28,1,modified,1,0,vendor/lib/lib_profile.cmd,medium,0
cmder,1754,1,6,modified,3,3,vendor/init.bat,medium,0
cmder,1751,6,27,modified,19,8,.github/issue_template.md,low,0
cmder,1751,6,31,modified,24,7,README.md,low,0
cmder,1751,6,216,modified,108,108,launcher/src/Resource.rc,low,0
cmder,1750,0,27,modified,21,6,bin/alias.bat,medium,0
cmder,1745,6,1,modified,1,0,launcher/src/CmderLauncher.cpp,high,1
cmder,1745,6,2,modified,1,1,vendor/init.bat,medium,0
cmder,1745,6,1,modified,0,1,vendor/lib/lib_console.cmd,medium,0
cmder,1745,6,2,modified,1,1,vendor/lib/lib_git.cmd,medium,0
cmder,1739,1,22,modified,11,11,vendor/cmder.sh,high,0
cmder,1739,1,45,modified,23,22,vendor/init.bat,medium,0
cmder,1739,1,2,modified,1,1,vendor/profile.ps1,high,0
cmder,1730,27,8,modified,7,1,launcher/CmderLauncher.vcxproj,medium,0
cmder,1730,27,0,modified,0,0,launcher/src/Resource.rc,low,0
cmder,1730,27,54,added,54,0,launcher/src/app.manifest,medium,0
cmder,1730,27,27,added,27,0,launcher/src/version.rc2.sample,NaN,0
cmder,1730,27,14,modified,12,2,scripts/build.ps1,high,0
cmder,1730,27,2,modified,1,1,scripts/pack.ps1,high,0
cmder,1730,27,79,modified,79,0,scripts/utils.ps1,high,0
cmder,1725,2,7,modified,0,7,launcher/src/CmderLauncher.cpp,high,1
cmder,1724,1,73,modified,42,31,launcher/src/CmderLauncher.cpp,high,2
cmder,1723,0,67,added,67,0,.github/issue_template.md,low,0
cmder,1707,2,3,modified,2,1,launcher/CmderLauncher.vcxproj,medium,0
cmder,1707,2,69,modified,30,39,launcher/src/CmderLauncher.cpp,high,2
cmder,1706,1,1,modified,1,0,.gitignore,low,0
cmder,1706,1,11,modified,11,0,CHANGELOG.md,low,0
cmder,1706,1,1,modified,0,1,README.md,low,0
cmder,1706,1,2,modified,1,1,launcher/CmderLauncher.vcxproj,medium,0
cmder,1706,1,2,modified,1,1,launcher/src/CmderLauncher.cpp,high,2
cmder,1706,1,286,modified,32,254,vendor/init.bat,medium,0
cmder,1706,1,48,added,48,0,vendor/lib/lib_base.cmd,medium,0
cmder,1706,1,80,added,80,0,vendor/lib/lib_console.cmd,medium,0
cmder,1706,1,168,added,168,0,vendor/lib/lib_git.cmd,medium,0
cmder,1706,1,155,added,155,0,vendor/lib/lib_path.cmd,medium,0
cmder,1706,1,46,added,46,0,vendor/lib/lib_profile.cmd,medium,0
cmder,1696,29,5,modified,5,0,.gitattributes,low,0
cmder,1696,29,57,modified,56,1,CHANGELOG.md,low,0
cmder,1696,29,107,modified,81,26,README.md,low,0
cmder,1696,29,215,modified,125,90,config/ConEmu.xml,medium,0
cmder,1696,29,3,modified,3,0,launcher/CmderLauncher.vcxproj,medium,0
cmder,1696,29,358,modified,251,107,launcher/src/CmderLauncher.cpp,high,2
cmder,1696,29,42,modified,30,12,vendor/cmder.sh,high,0
cmder,1696,29,54,modified,37,17,vendor/cmder_exinit,NaN,0
cmder,1696,29,413,modified,325,88,vendor/init.bat,medium,0
cmder,1696,29,32,modified,31,1,vendor/profile.ps1,high,0
cmder,1694,33,5,modified,5,0,.gitattributes,low,1
cmder,1694,33,57,modified,56,1,CHANGELOG.md,low,1
cmder,1694,33,107,modified,81,26,README.md,low,1
cmder,1694,33,215,modified,125,90,config/ConEmu.xml,medium,1
cmder,1694,33,3,modified,3,0,launcher/CmderLauncher.vcxproj,medium,1
cmder,1694,33,271,modified,194,77,launcher/src/CmderLauncher.cpp,high,3
cmder,1694,33,42,modified,30,12,vendor/cmder.sh,high,1
cmder,1694,33,54,modified,37,17,vendor/cmder_exinit,NaN,1
cmder,1694,33,409,modified,323,86,vendor/init.bat,medium,1
cmder,1694,33,32,modified,31,1,vendor/profile.ps1,high,1
cmder,1693,0,8,modified,3,5,vendor/clink.lua,NaN,1
cmder,1692,0,8,modified,3,5,vendor/clink.lua,NaN,2
cmder,1690,1,21,modified,18,3,vendor/init.bat,medium,2
cmder,1683,54,1,modified,1,0,.gitignore,low,1
cmder,1683,54,70,modified,69,1,CHANGELOG.md,low,2
cmder,1683,54,107,modified,81,26,README.md,low,2
cmder,1683,54,215,modified,125,90,config/ConEmu.xml,medium,2
cmder,1683,54,3,modified,3,0,launcher/CmderLauncher.vcxproj,medium,2
cmder,1683,54,219,modified,144,75,launcher/src/CmderLauncher.cpp,high,4
cmder,1683,54,42,modified,30,12,vendor/cmder.sh,high,2
cmder,1683,54,54,modified,37,17,vendor/cmder_exinit,NaN,2
cmder,1683,54,293,modified,148,145,vendor/init.bat,medium,3
cmder,1683,54,46,added,46,0,vendor/lib/lib_base.cmd,medium,1
cmder,1683,54,80,added,80,0,vendor/lib/lib_console.cmd,medium,1
cmder,1683,54,111,added,111,0,vendor/lib/lib_git.cmd,medium,1
cmder,1683,54,155,added,155,0,vendor/lib/lib_path.cmd,medium,1
cmder,1683,54,46,added,46,0,vendor/lib/lib_profile.cmd,medium,1
cmder,1683,54,28,modified,27,1,vendor/profile.ps1,high,2
cmder,1682,40,1,modified,1,0,.gitignore,low,2
cmder,1682,40,70,modified,69,1,CHANGELOG.md,low,3
cmder,1682,40,107,modified,81,26,README.md,low,3
cmder,1682,40,215,modified,125,90,config/ConEmu.xml,medium,3
cmder,1682,40,3,modified,3,0,launcher/CmderLauncher.vcxproj,medium,3
cmder,1682,40,219,modified,144,75,launcher/src/CmderLauncher.cpp,high,5
cmder,1682,40,42,modified,30,12,vendor/cmder.sh,high,3
cmder,1682,40,54,modified,37,17,vendor/cmder_exinit,NaN,3
cmder,1682,40,293,modified,148,145,vendor/init.bat,medium,4
cmder,1682,40,46,added,46,0,vendor/lib/lib_base.cmd,medium,2
cmder,1682,40,80,added,80,0,vendor/lib/lib_console.cmd,medium,2
cmder,1682,40,155,added,155,0,vendor/lib/lib_path.cmd,medium,2
cmder,1682,40,46,added,46,0,vendor/lib/lib_profile.cmd,medium,2
cmder,1682,40,28,modified,27,1,vendor/profile.ps1,high,3
cmder,1665,66,5,modified,5,0,.gitattributes,low,2
cmder,1665,66,1,modified,1,0,.gitignore,low,3
cmder,1665,66,103,modified,101,2,CHANGELOG.md,low,4
cmder,1665,66,21,added,21,0,LICENSE,low,1
cmder,1665,66,176,modified,144,32,README.md,low,4
cmder,1665,66,32,modified,16,16,bin/alias.bat,medium,1
cmder,1665,66,229,modified,132,97,config/ConEmu.xml,medium,4
cmder,1665,66,3,modified,3,0,launcher/CmderLauncher.vcxproj,medium,4
cmder,1665,66,298,modified,207,91,launcher/src/CmderLauncher.cpp,high,6
cmder,1665,66,0,modified,0,0,launcher/src/Resource.rc,low,1
cmder,1665,66,0,modified,0,0,launcher/src/resource.h,high,1
cmder,1665,66,215,modified,120,95,vendor/clink.lua,NaN,3
cmder,1665,66,42,modified,30,12,vendor/cmder.sh,high,4
cmder,1665,66,54,modified,37,17,vendor/cmder_exinit,NaN,4
cmder,1665,66,461,modified,409,52,vendor/init.bat,medium,5
cmder,1665,66,57,modified,42,15,vendor/profile.ps1,high,4
cmder,1665,66,16,modified,8,8,vendor/sources.json,medium,1
cmder,1660,0,46,modified,45,1,CHANGELOG.md,low,4
cmder,1658,0,8,modified,7,1,README.md,low,4
cmder,1658,0,132,modified,124,8,vendor/init.bat,medium,5
cmder,1635,5,1,modified,1,0,.gitignore,low,4
cmder,1635,5,33,modified,33,0,README.md,low,5
cmder,1635,5,158,modified,128,30,vendor/init.bat,medium,6
cmder,1611,2,8,modified,8,0,vendor/init.bat,medium,6
cmder,1609,2,18,modified,9,9,config/ConEmu.xml,medium,4
cmder,1609,2,49,modified,20,29,launcher/src/CmderLauncher.cpp,high,6
cmder,1609,2,0,modified,0,0,launcher/src/Resource.rc,low,1
cmder,1609,2,0,modified,0,0,launcher/src/resource.h,high,1
cmder,1609,2,10,modified,2,8,vendor/init.bat,medium,6
cmder,1609,2,7,modified,0,7,vendor/profile.ps1,high,4
cmder,1592,1,1,modified,1,0,.gitignore,low,4
cmder,1591,2,28,modified,28,0,README.md,low,5
cmder,1547,1,2,modified,1,1,vendor/init.bat,medium,6
cmder,1531,2,30,modified,15,15,bin/alias.bat,medium,1
cmder,1525,1,4,modified,2,2,vendor/sources.json,medium,2
cmder,1517,1,2,modified,1,1,vendor/profile.ps1,high,4
cmder,1505,1,21,added,21,0,LICENSE,low,1
cmder,1504,2,2,modified,1,1,README.md,low,5
cmder,1504,2,18,modified,9,9,config/ConEmu.xml,medium,4
cmder,1483,1,7,modified,7,0,vendor/init.bat,medium,7
cmder,1475,0,2,modified,1,1,appveyor.yml,medium,1
cmder,1474,1,2,modified,1,1,README.md,low,5
cmder,1456,1,2,modified,1,1,vendor/init.bat,medium,8
cmder,1453,1,27,modified,25,2,README.md,low,5
cmder,1441,0,6,modified,5,1,vendor/profile.ps1,high,4
cmder,1434,2,57,modified,37,20,vendor/git-prompt.sh,high,0
cmder,1417,2,16,modified,10,6,vendor/profile.ps1,high,4
cmder,1416,1,6,modified,5,1,vendor/init.bat,medium,8
cmder,1407,3,12,modified,10,2,launcher/src/CmderLauncher.cpp,high,6
cmder,1399,5,13,modified,9,4,vendor/init.bat,medium,8
cmder,1391,1,7,modified,7,0,vendor/init.bat,medium,8
cmder,1372,7,17,modified,9,8,launcher/src/CmderLauncher.cpp,high,7
cmder,1372,7,22,modified,22,0,vendor/init.bat,medium,9
cmder,1372,7,26,modified,26,0,vendor/profile.ps1,high,5
cmder,1360,1,2,modified,1,1,bin/alias.bat,medium,1
cmder,1360,1,4,modified,2,2,config/ConEmu.xml,medium,4
cmder,1331,1,50,modified,49,1,vendor/clink.lua,NaN,3
cmder,1317,1,18,modified,9,9,config/Readme.md,low,0
cmder,1310,2,1,modified,1,0,vendor/init.bat,medium,9
cmder,1310,2,2,modified,1,1,vendor/user-aliases.cmd.example,medium,0
cmder,1299,1,2,modified,1,1,vendor/clink.lua,NaN,3
cmder,1282,1,30,modified,16,14,vendor/profile.ps1,high,6
cmder,1280,1,58,modified,29,29,vendor/profile.ps1,high,6
cmder,1268,1,2,modified,1,1,config/Readme.md,low,0
cmder,1256,1,13,modified,8,5,vendor/profile.ps1,high,6
cmder,1255,57,705,added,705,0,CHANGELOG.md,low,5
cmder,1255,57,2,modified,1,1,Cmder.bat,medium,1
cmder,1255,57,9,modified,6,3,README.md,low,6
cmder,1255,57,3,modified,3,0,appveyor.yml,medium,2
cmder,1255,57,2,modified,1,1,bin/alias.bat,medium,2
cmder,1255,57,4,modified,2,2,config/Readme.md,low,1
cmder,1255,57,47,modified,34,13,launcher/src/CmderLauncher.cpp,high,8
cmder,1255,57,12,modified,12,0,scripts/build.ps1,high,1
cmder,1255,57,1,modified,1,0,scripts/utils.ps1,high,1
cmder,1255,57,34,modified,28,6,vendor/clink.lua,NaN,4
cmder,1255,57,14,modified,7,7,vendor/cmder.sh,high,5
cmder,1255,57,16,modified,8,8,vendor/cmder_exinit,NaN,5
cmder,1255,57,4,modified,2,2,vendor/init.bat,medium,10
cmder,1255,57,13,modified,8,5,vendor/profile.ps1,high,7
cmder,1255,57,12,modified,6,6,vendor/sources.json,medium,3
cmder,1255,57,2,modified,1,1,vendor/user-aliases.cmd.example,medium,1
cmder,1252,1,2,modified,1,1,bin/alias.bat,medium,2
cmder,1246,1,2,modified,1,1,vendor/sources.json,medium,4
cmder,1189,1,3,modified,3,0,README.md,low,6
cmder,1169,10,1,modified,1,0,.gitignore,low,4
cmder,1169,10,113,modified,87,26,vendor/profile.ps1,high,7
cmder,1169,10,8,modified,4,4,vendor/sources.json,medium,4
cmder,1157,1,4,modified,2,2,vendor/init.bat,medium,10
cmder,1153,1,4,modified,2,2,vendor/sources.json,medium,4
cmder,1143,0,6,modified,3,3,README.md,low,6
cmder,1131,1,8,modified,5,3,launcher/src/CmderLauncher.cpp,high,8
cmder,1127,4,2,modified,1,1,config/ConEmu.xml,medium,4
cmder,1127,4,5,modified,4,1,vendor/clink.lua,NaN,4
cmder,1126,0,2,modified,1,1,vendor/user-aliases.cmd.example,medium,1
cmder,1109,6,2,modified,1,1,Cmder.bat,medium,1
cmder,1109,6,39,modified,29,10,launcher/src/CmderLauncher.cpp,high,8
cmder,1101,0,5,modified,4,1,vendor/clink.lua,NaN,4
cmder,1082,1,4,modified,2,2,config/Readme.md,low,1
cmder,1078,2,14,modified,7,7,vendor/cmder.sh,high,5
cmder,1078,2,16,modified,8,8,vendor/cmder_exinit,NaN,5
cmder,1070,1,30,modified,26,4,vendor/clink.lua,NaN,4
cmder,1042,1,12,modified,12,0,scripts/build.ps1,high,1
cmder,1042,1,1,modified,1,0,scripts/utils.ps1,high,1
cmder,1037,60,40,modified,17,23,README.md,low,6
cmder,1037,60,125,modified,96,29,bin/alias.bat,medium,2
cmder,1037,60,0,added,0,0,icons/cmder_blue.ico,low,0
cmder,1037,60,0,added,0,0,icons/cmder_green.ico,low,0
cmder,1037,60,0,modified,0,0,icons/cmder_icon.psd,low,0
cmder,1037,60,0,added,0,0,icons/cmder_orange.ico,low,0
cmder,1037,60,0,added,0,0,icons/cmder_purple.ico,low,0
cmder,1037,60,0,added,0,0,icons/cmder_red.ico,low,0
cmder,1037,60,0,added,0,0,icons/cmder_yellow.ico,low,0
cmder,1037,60,0,added,0,0,icons/icon_16_blue.png,low,0
cmder,1037,60,0,added,0,0,icons/icon_16_green.png,low,0
cmder,1037,60,0,added,0,0,icons/icon_16_orange.png,low,0
cmder,1037,60,0,added,0,0,icons/icon_16_purple.png,low,0
cmder,1037,60,0,added,0,0,icons/icon_16_red.png,low,0
cmder,1037,60,0,added,0,0,icons/icon_16_yellow.png,low,0
cmder,1037,60,0,added,0,0,icons/icon_256_blue.png,low,0
cmder,1037,60,0,added,0,0,icons/icon_256_green.png,low,0
cmder,1037,60,0,added,0,0,icons/icon_256_orange.png,low,0
cmder,1037,60,0,added,0,0,icons/icon_256_purple.png,low,0
cmder,1037,60,0,added,0,0,icons/icon_256_red.png,low,0
cmder,1037,60,0,added,0,0,icons/icon_256_yellow.png,low,0
cmder,1037,60,0,added,0,0,icons/icon_32_blue.png,low,0
cmder,1037,60,0,added,0,0,icons/icon_32_green.png,low,0
cmder,1037,60,0,added,0,0,icons/icon_32_orange.png,low,0
cmder,1037,60,0,added,0,0,icons/icon_32_purple.png,low,0
cmder,1037,60,0,added,0,0,icons/icon_32_red.png,low,0
cmder,1037,60,0,added,0,0,icons/icon_32_yellow.png,low,0
cmder,1037,60,0,added,0,0,icons/icon_48_blue.png,low,0
cmder,1037,60,0,added,0,0,icons/icon_48_green.png,low,0
cmder,1037,60,0,added,0,0,icons/icon_48_orange.png,low,0
cmder,1026,1,2,modified,1,1,README.md,low,7
cmder,1016,1,2,modified,1,1,README.md,low,7
cmder,1014,1,0,added,0,0,icons/cmder_blue.ico,low,0
cmder,1014,1,0,added,0,0,icons/cmder_green.ico,low,0
cmder,1014,1,0,modified,0,0,icons/cmder_icon.psd,low,0
cmder,1014,1,0,added,0,0,icons/cmder_orange.ico,low,0
cmder,1014,1,0,added,0,0,icons/cmder_purple.ico,low,0
cmder,1014,1,0,added,0,0,icons/cmder_red.ico,low,0
cmder,1014,1,0,added,0,0,icons/cmder_yellow.ico,low,0
cmder,1014,1,0,added,0,0,icons/icon_16_blue.png,low,0
cmder,1014,1,0,added,0,0,icons/icon_16_green.png,low,0
cmder,1014,1,0,added,0,0,icons/icon_16_orange.png,low,0
cmder,1014,1,0,added,0,0,icons/icon_16_purple.png,low,0
cmder,1014,1,0,added,0,0,icons/icon_16_red.png,low,0
cmder,1014,1,0,added,0,0,icons/icon_16_yellow.png,low,0
cmder,1014,1,0,added,0,0,icons/icon_256_blue.png,low,0
cmder,1014,1,0,added,0,0,icons/icon_256_green.png,low,0
cmder,1014,1,0,added,0,0,icons/icon_256_orange.png,low,0
cmder,1014,1,0,added,0,0,icons/icon_256_purple.png,low,0
cmder,1014,1,0,added,0,0,icons/icon_256_red.png,low,0
cmder,1014,1,0,added,0,0,icons/icon_256_yellow.png,low,0
cmder,1014,1,0,added,0,0,icons/icon_32_blue.png,low,0
cmder,1014,1,0,added,0,0,icons/icon_32_green.png,low,0
cmder,1014,1,0,added,0,0,icons/icon_32_orange.png,low,0
cmder,1014,1,0,added,0,0,icons/icon_32_purple.png,low,0
cmder,1014,1,0,added,0,0,icons/icon_32_red.png,low,0
cmder,1014,1,0,added,0,0,icons/icon_32_yellow.png,low,0
cmder,1014,1,0,added,0,0,icons/icon_48_blue.png,low,0
cmder,1014,1,0,added,0,0,icons/icon_48_green.png,low,0
cmder,1014,1,0,added,0,0,icons/icon_48_orange.png,low,0
cmder,1014,1,0,added,0,0,icons/icon_48_purple.png,low,0
cmder,1014,1,0,added,0,0,icons/icon_48_red.png,low,0
cmder,1013,7,514,added,514,0,CHANGELOG.md,low,6
cmder,1013,7,0,added,0,0,icons/cmder_blue.ico,low,1
cmder,1013,7,0,added,0,0,icons/cmder_green.ico,low,1
cmder,1013,7,0,modified,0,0,icons/cmder_icon.psd,low,1
cmder,1013,7,0,added,0,0,icons/cmder_orange.ico,low,1
cmder,1013,7,0,added,0,0,icons/cmder_purple.ico,low,1
cmder,1013,7,0,added,0,0,icons/cmder_red.ico,low,1
cmder,1013,7,0,added,0,0,icons/cmder_yellow.ico,low,1
cmder,1013,7,0,added,0,0,icons/icon_16_blue.png,low,1
cmder,1013,7,0,added,0,0,icons/icon_16_green.png,low,1
cmder,1013,7,0,added,0,0,icons/icon_16_orange.png,low,1
cmder,1013,7,0,added,0,0,icons/icon_16_purple.png,low,1
cmder,1013,7,0,added,0,0,icons/icon_16_red.png,low,1
cmder,1013,7,0,added,0,0,icons/icon_16_yellow.png,low,1
cmder,1013,7,0,added,0,0,icons/icon_256_blue.png,low,1
cmder,1013,7,0,added,0,0,icons/icon_256_green.png,low,1
cmder,1013,7,0,added,0,0,icons/icon_256_orange.png,low,1
cmder,1013,7,0,added,0,0,icons/icon_256_purple.png,low,1
cmder,1013,7,0,added,0,0,icons/icon_256_red.png,low,1
cmder,1013,7,0,added,0,0,icons/icon_256_yellow.png,low,1
cmder,1013,7,0,added,0,0,icons/icon_32_blue.png,low,1
cmder,1013,7,0,added,0,0,icons/icon_32_green.png,low,1
cmder,1013,7,0,added,0,0,icons/icon_32_orange.png,low,1
cmder,1013,7,0,added,0,0,icons/icon_32_purple.png,low,1
cmder,1013,7,0,added,0,0,icons/icon_32_red.png,low,1
cmder,1013,7,0,added,0,0,icons/icon_32_yellow.png,low,1
cmder,1013,7,0,added,0,0,icons/icon_48_blue.png,low,1
cmder,1013,7,0,added,0,0,icons/icon_48_green.png,low,1
cmder,1013,7,0,added,0,0,icons/icon_48_orange.png,low,1
cmder,1013,7,0,added,0,0,icons/icon_48_purple.png,low,1
cmder,1011,1,9,modified,4,5,vendor/clink.lua,NaN,4
cmder,999,0,2,modified,1,1,vendor/profile.ps1,high,8
Squirrel.Windows,1392,2,2,modified,1,1,src/Update/Program.cs,high,1
Squirrel.Windows,1387,1,50,added,50,0,src/Squirrel/ExceptionTypes.cs,high,0
Squirrel.Windows,1387,1,1,modified,1,0,src/Squirrel/Squirrel.csproj,low,0
Squirrel.Windows,1387,1,8,modified,4,4,src/Squirrel/UpdateManager.CheckForUpdates.cs,high,0
Squirrel.Windows,1387,1,2,modified,1,1,src/Squirrel/UpdateManager.cs,high,0
Squirrel.Windows,1382,2,61,modified,59,2,src/Squirrel/ShellFile.cs,high,0
Squirrel.Windows,1379,1,5,modified,5,0,src/Squirrel/ReleaseEntry.cs,high,0
Squirrel.Windows,1379,1,12,modified,10,2,src/Update/Program.cs,high,1
Squirrel.Windows,1370,1,16,modified,11,5,src/Update/Program.cs,high,1
Squirrel.Windows,1368,1,8,modified,5,3,src/Update/Program.cs,high,1
Squirrel.Windows,1366,1,1,modified,1,0,src/Squirrel.nuspec,medium,0
Squirrel.Windows,1366,1,5,added,5,0,src/Squirrel.targets,low,0
Squirrel.Windows,1365,1,1,modified,1,0,src/Squirrel.nuspec,medium,0
Squirrel.Windows,1365,1,5,added,5,0,src/Squirrel.props,medium,0
Squirrel.Windows,1362,1,2,modified,1,1,src/Squirrel.nuspec,medium,0
Squirrel.Windows,1362,1,12,modified,6,6,src/Squirrel/BinaryPatchUtility.cs,high,0
Squirrel.Windows,1362,1,4,modified,2,2,src/Squirrel/Squirrel.csproj,low,0
Squirrel.Windows,1362,1,2,modified,1,1,src/Squirrel/packages.config,medium,0
Squirrel.Windows,1362,1,4,modified,2,2,src/SyncReleases/SyncReleases.csproj,low,0
Squirrel.Windows,1362,1,14,modified,7,7,src/SyncReleases/packages.config,medium,0
Squirrel.Windows,1362,1,4,modified,2,2,src/Update/Update-Mono.csproj,low,0
Squirrel.Windows,1362,1,2,modified,1,1,src/Update/packages.config,medium,0
Squirrel.Windows,1362,1,4,modified,2,2,test/Squirrel.Tests.csproj,low,0
Squirrel.Windows,1362,1,2,modified,1,1,test/packages.config,medium,0
Squirrel.Windows,1361,1,18,modified,12,6,src/Squirrel/BinaryPatchUtility.cs,high,0
Squirrel.Windows,1359,1,1,modified,1,0,.gitignore,low,0
Squirrel.Windows,1359,1,14,modified,8,6,docs/using/nuget-package-metadata.md,low,0
Squirrel.Windows,1359,1,5,modified,5,0,src/Update/Program.cs,high,1
Squirrel.Windows,1359,1,2,modified,1,1,vendor/wix/template.wxs,medium,0
Squirrel.Windows,1355,1,1,modified,1,0,.gitignore,low,0
Squirrel.Windows,1355,1,9,modified,8,1,src/Squirrel/Utility.cs,high,0
Squirrel.Windows,1355,1,15,modified,8,7,src/Update/Program.cs,high,1
Squirrel.Windows,1353,3,3,modified,2,1,.gitmodules,low,0
Squirrel.Windows,1353,3,27,modified,27,0,test/ReleaseEntryTests.cs,high,0
Squirrel.Windows,1353,3,2,modified,1,1,vendor/nuget,NaN,0
Squirrel.Windows,1348,1,4,modified,3,1,docs/getting-started/1-integrating.md,low,1
Squirrel.Windows,1340,1,4,modified,2,2,src/Squirrel/UpdateManager.ApplyReleases.cs,high,1
Squirrel.Windows,1328,1,1800,modified,904,896,src/Update/Program.cs,high,1
Squirrel.Windows,1326,2,13,modified,2,11,src/Squirrel/Squirrel.csproj,low,0
Squirrel.Windows,1326,2,14,modified,7,7,src/Squirrel/packages.config,medium,0
Squirrel.Windows,1326,2,10,modified,5,5,src/Update/App.config,medium,0
Squirrel.Windows,1326,2,5,modified,2,3,src/Update/Update-Mono.csproj,low,0
Squirrel.Windows,1326,2,20,modified,10,10,src/Update/packages.config,medium,0
Squirrel.Windows,1326,2,13,modified,2,11,test/Squirrel.Tests.csproj,low,0
Squirrel.Windows,1326,2,28,modified,14,14,test/packages.config,medium,0
Squirrel.Windows,1312,1,3,modified,0,3,src/Squirrel/DeltaPackage.cs,high,0
Squirrel.Windows,1306,1,4,modified,4,0,src/Setup/FxHelper.cpp,high,0
Squirrel.Windows,1306,1,2,modified,1,1,src/Setup/FxHelper.h,high,0
Squirrel.Windows,1306,1,0,modified,0,0,src/Setup/Setup.rc,low,0
Squirrel.Windows,1301,1,14,modified,14,0,docs/using/application-signing.md,low,0
Squirrel.Windows,1295,1,2,modified,1,1,src/Update/Program.cs,high,1
Squirrel.Windows,1294,1,2,modified,1,1,vendor/nuget,NaN,0
Squirrel.Windows,1290,2,2,modified,1,1,docs/faq.md,low,0
Squirrel.Windows,1285,1,4,modified,2,2,docs/faq.md,low,0
Squirrel.Windows,1284,1,4,modified,4,0,src/Setup/FxHelper.cpp,high,0
Squirrel.Windows,1284,1,2,modified,1,1,src/Setup/FxHelper.h,high,0
Squirrel.Windows,1284,1,0,modified,0,0,src/Setup/Setup.rc,low,0
Squirrel.Windows,1278,4,10,modified,5,5,src/Update/Program.cs,high,1
Squirrel.Windows,1248,1,6,modified,3,3,src/Setup/Setup.vcxproj,medium,0
Squirrel.Windows,1248,1,103,modified,91,12,src/Setup/UpdateRunner.cpp,high,0
Squirrel.Windows,1248,1,4,modified,3,1,src/Setup/UpdateRunner.h,high,0
Squirrel.Windows,1246,1,8,modified,6,2,src/Setup/UpdateRunner.cpp,high,0
Squirrel.Windows,1246,1,10,modified,10,0,src/Squirrel/UpdateManager.ApplyReleases.cs,high,1
Squirrel.Windows,1242,1,8,modified,7,1,src/Update/AnimatedGifWindow.cs,high,0
Squirrel.Windows,1242,1,10,modified,8,2,src/Update/Program.cs,high,1
Squirrel.Windows,1239,1,98,modified,62,36,docs/using/squirrel-command-line.md,low,0
Squirrel.Windows,1233,3,136,removed,0,136,src/Update/AnimatedGifWindowWinForms.cs,high,0
Squirrel.Windows,1233,3,23,modified,12,11,src/Update/Program.cs,high,1
Squirrel.Windows,1233,3,113,removed,0,113,src/Update/TaskbarCOMInterfaces.cs,high,0
Squirrel.Windows,1233,3,65,removed,0,65,src/Update/TaskbarEnums.cs,high,0
Squirrel.Windows,1233,3,15,removed,0,15,src/Update/TaskbarInterfaces.cs,high,0
Squirrel.Windows,1233,3,33,removed,0,33,src/Update/TaskbarList.cs,high,0
Squirrel.Windows,1233,3,251,removed,0,251,src/Update/TaskbarManager.cs,high,0
Squirrel.Windows,1233,3,145,removed,0,145,src/Update/TaskbarNativeMethods.cs,high,0
Squirrel.Windows,1233,3,17,modified,6,11,src/Update/Update.csproj,low,0
Squirrel.Windows,1233,3,1,modified,1,0,src/Update/packages.config,medium,0
Squirrel.Windows,1226,1,17,modified,17,0,src/Update/AnimatedGifWindowWinForms.cs,high,0
Squirrel.Windows,1224,9,50,modified,29,21,src/Update/AnimatedGifWindowWinForms.cs,high,1
Squirrel.Windows,1206,1,2,modified,1,1,docs/using/update-process.md,low,0
Squirrel.Windows,1190,1,29,modified,28,1,docs/using/teamcity.md,low,0
Squirrel.Windows,1189,7,12,renamed,6,6,contributing.md,low,0
Squirrel.Windows,1189,7,0,renamed,0,0,copying,low,0
Squirrel.Windows,1189,7,2,modified,1,1,docs/faq.md,low,0
Squirrel.Windows,1189,7,2,modified,2,0,docs/getting-started/2-packaging.md,low,0
Squirrel.Windows,1189,7,2,modified,1,1,docs/readme.md,low,0
Squirrel.Windows,1189,7,17,modified,14,3,docs/using/debugging-updates.md,low,0
Squirrel.Windows,1189,7,10,renamed,3,7,readme.md,low,0
Squirrel.Windows,1188,5,93,modified,65,28,docs/using/visual-studio-packaging.md,low,0
Squirrel.Windows,1171,18,3,modified,3,0,.gitignore,low,1
Squirrel.Windows,1171,18,2,modified,1,1,.gitmodules,low,1
Squirrel.Windows,1171,18,35,modified,24,11,src/Setup/FxHelper.cpp,high,1
Squirrel.Windows,1171,18,226,added,226,0,src/Setup/LicenseDialog.cpp,high,1
Squirrel.Windows,1171,18,34,added,34,0,src/Setup/LicenseDialog.h,high,1
Squirrel.Windows,1171,18,0,modified,0,0,src/Setup/Setup.rc,low,1
Squirrel.Windows,1171,18,12,modified,8,4,src/Setup/Setup.vcxproj,medium,1
Squirrel.Windows,1171,18,9,modified,9,0,src/Setup/Setup.vcxproj.filters,medium,1
Squirrel.Windows,1171,18,29,modified,19,10,src/Setup/UpdateRunner.cpp,high,1
Squirrel.Windows,1171,18,0,added,0,0,src/Setup/license.bin,low,1
Squirrel.Windows,1171,18,0,modified,0,0,src/Setup/resource.h,high,1
Squirrel.Windows,1171,18,27,modified,23,4,src/Setup/winmain.cpp,high,1
Squirrel.Windows,1171,18,2,modified,1,1,src/SolutionAssemblyInfo.cs,high,1
Squirrel.Windows,1171,18,4,modified,2,2,src/Squirrel.nuspec,medium,1
Squirrel.Windows,1171,18,10,modified,5,5,src/StubExecutable/StubExecutable.vcxproj,medium,1
Squirrel.Windows,1171,18,11,modified,9,2,src/Update/Program.cs,high,2
Squirrel.Windows,1171,18,17,modified,10,7,src/Update/Update.csproj,low,1
Squirrel.Windows,1171,18,86,modified,79,7,src/WriteZipToSetup/WriteZipToSetup.cpp,high,1
Squirrel.Windows,1171,18,8,modified,4,4,src/WriteZipToSetup/WriteZipToSetup.vcxproj,medium,1
Squirrel.Windows,1171,18,2,modified,1,1,test/packages.config,medium,1
Squirrel.Windows,1167,5,2,modified,1,1,.gitmodules,low,2
Squirrel.Windows,1167,5,9,modified,5,4,src/Setup/Setup.vcxproj,medium,2
Squirrel.Windows,1167,5,10,modified,5,5,src/StubExecutable/StubExecutable.vcxproj,medium,2
Squirrel.Windows,1167,5,17,modified,10,7,src/Update/Update.csproj,low,2
Squirrel.Windows,1167,5,8,modified,4,4,src/WriteZipToSetup/WriteZipToSetup.vcxproj,medium,2
Squirrel.Windows,1167,5,2,modified,1,1,test/packages.config,medium,2
Squirrel.Windows,1166,910,5,modified,4,1,.gitattributes,low,0
Squirrel.Windows,1166,910,8,modified,8,0,.gitignore,low,1
Squirrel.Windows,1166,910,4,added,4,0,.gitmodules,low,2
Squirrel.Windows,1166,910,0,modified,0,0,.nuget/NuGet.exe,medium,0
Squirrel.Windows,1166,910,4,modified,2,2,.nuget/packages.config,medium,0
Squirrel.Windows,1166,910,59,modified,32,27,README.md,low,0
Squirrel.Windows,1166,910,441,modified,438,3,Squirrel.sln,low,0
Squirrel.Windows,1166,910,43,removed,0,43,docs/advanced-releasify.md,low,0
Squirrel.Windows,1166,910,54,removed,0,54,docs/api.md,low,0
Squirrel.Windows,1166,910,0,added,0,0,docs/artwork/Squirrel-Logo-Square.png,low,0
Squirrel.Windows,1166,910,0,added,0,0,docs/artwork/Squirrel-Logo.png,low,0
Squirrel.Windows,1166,910,203,added,203,0,docs/artwork/Squirrel-Logo.svg,medium,0
Squirrel.Windows,1166,910,22,added,22,0,docs/contributing/building-squirrel.md,low,0
Squirrel.Windows,1166,910,21,added,21,0,docs/contributing/contributing.md,low,0
Squirrel.Windows,1166,910,29,added,29,0,docs/contributing/vs-solution-overview.md,low,0
Squirrel.Windows,1166,910,71,added,71,0,docs/faq.md,low,0
Squirrel.Windows,1166,910,40,removed,0,40,docs/getting-started.md,low,0
Squirrel.Windows,1166,910,34,added,34,0,docs/getting-started/0-overview.md,low,0
Squirrel.Windows,1166,910,61,added,61,0,docs/getting-started/1-integrating.md,low,1
Squirrel.Windows,1166,910,80,added,80,0,docs/getting-started/2-packaging.md,low,0
Squirrel.Windows,1166,910,22,added,22,0,docs/getting-started/3-distributing.md,low,0
Squirrel.Windows,1166,910,31,added,31,0,docs/getting-started/4-installing.md,low,0
Squirrel.Windows,1166,910,99,added,99,0,docs/getting-started/5-updating.md,low,0
Squirrel.Windows,1166,910,0,added,0,0,docs/getting-started/example/MyApp.zip,low,0
Squirrel.Windows,1166,910,0,added,0,0,docs/getting-started/images/1-MyApp-Solution.png,low,0
Squirrel.Windows,1166,910,0,added,0,0,docs/getting-started/images/1-MyApp.png,low,0
Squirrel.Windows,1166,910,0,added,0,0,docs/getting-started/images/1.1-post-package-install.png,low,0
Squirrel.Windows,1166,910,0,added,0,0,docs/getting-started/images/1.2-nuget-package-explorer.png,low,0
Squirrel.Windows,1166,910,0,added,0,0,docs/getting-started/images/1.2-releases-directory.png,low,0
Squirrel.Windows,1166,910,0,added,0,0,docs/getting-started/images/1.3-local-app-data-dir.png,low,0
Squirrel.Windows,1137,16,3,modified,3,0,.gitignore,low,1
Squirrel.Windows,1137,16,2,modified,1,1,.gitmodules,low,2
Squirrel.Windows,1137,16,5,modified,3,2,src/Setup/FxHelper.cpp,high,1
Squirrel.Windows,1137,16,223,added,223,0,src/Setup/LicenseDialog.cpp,high,1
Squirrel.Windows,1137,16,34,added,34,0,src/Setup/LicenseDialog.h,high,1
Squirrel.Windows,1137,16,0,modified,0,0,src/Setup/Setup.rc,low,1
Squirrel.Windows,1137,16,12,modified,8,4,src/Setup/Setup.vcxproj,medium,2
Squirrel.Windows,1137,16,9,modified,9,0,src/Setup/Setup.vcxproj.filters,medium,1
Squirrel.Windows,1137,16,0,added,0,0,src/Setup/license.bin,low,1
Squirrel.Windows,1137,16,0,modified,0,0,src/Setup/resource.h,high,1
Squirrel.Windows,1137,16,15,modified,13,2,src/Setup/winmain.cpp,high,1
Squirrel.Windows,1137,16,2,modified,1,1,src/SolutionAssemblyInfo.cs,high,1
Squirrel.Windows,1137,16,4,modified,2,2,src/Squirrel.nuspec,medium,1
Squirrel.Windows,1137,16,10,modified,5,5,src/StubExecutable/StubExecutable.vcxproj,medium,2
Squirrel.Windows,1137,16,11,modified,9,2,src/Update/Program.cs,high,3
Squirrel.Windows,1137,16,17,modified,10,7,src/Update/Update.csproj,low,2
Squirrel.Windows,1137,16,86,modified,79,7,src/WriteZipToSetup/WriteZipToSetup.cpp,high,1
Squirrel.Windows,1137,16,8,modified,4,4,src/WriteZipToSetup/WriteZipToSetup.vcxproj,medium,2
Squirrel.Windows,1137,16,2,modified,1,1,test/packages.config,medium,2
Squirrel.Windows,1123,1,88,modified,88,0,src/Squirrel/DeltaPackage.cs,high,0
Squirrel.Windows,1123,1,26,modified,11,15,src/Squirrel/UpdateManager.ApplyReleases.cs,high,2
Squirrel.Windows,1121,8,270,added,270,0,src/Squirrel/CatalogTools.cs,high,1
Squirrel.Windows,1121,8,4,modified,2,2,src/Squirrel/IUpdateManager.cs,high,1
Squirrel.Windows,1121,8,1,modified,1,0,src/Squirrel/Squirrel.csproj,low,1
Squirrel.Windows,1121,8,121,modified,118,3,src/Squirrel/UpdateManager.CheckForUpdates.cs,high,2
Squirrel.Windows,1121,8,2,modified,1,1,src/Squirrel/UpdateManager.DownloadReleases.cs,high,1
Squirrel.Windows,1121,8,12,modified,10,2,src/Squirrel/UpdateManager.cs,high,1
Squirrel.Windows,1121,8,20,modified,20,0,src/Update/Program.cs,high,4
Squirrel.Windows,1121,8,78,added,78,0,src/Update/Properties/Resources.Designer.cs,high,1
Squirrel.Windows,1121,8,124,added,124,0,src/Update/Properties/Resources.resx,medium,1
Squirrel.Windows,1121,8,7,added,7,0,src/Update/Resources/RELEASES_CDF.txt,low,1
Squirrel.Windows,1121,8,15,modified,15,0,src/Update/Update.csproj,low,3
Squirrel.Windows,1120,3,41,modified,25,16,docs/using/visual-studio-packaging.md,low,0
Squirrel.Windows,1115,1,3,modified,3,0,src/SyncReleases/SyncImplementations.cs,high,0
Squirrel.Windows,1112,1,3,modified,1,2,README.md,low,0
Squirrel.Windows,1106,1,63,modified,63,0,src/Squirrel/UpdateManager.DownloadReleases.cs,high,2
Squirrel.Windows,1106,1,8,modified,8,0,src/Squirrel/UpdateManager.cs,high,2
Squirrel.Windows,1103,2,3,modified,2,1,docs/using/custom-squirrel-events-non-cs.md,low,1
Squirrel.Windows,1103,2,3,modified,1,2,src/Squirrel/SquirrelAwareExecutableDetector.cs,high,1
Squirrel.Windows,1100,9,2,modified,2,0,.gitignore,low,1
Squirrel.Windows,1085,0,2,modified,1,1,docs/using/visual-studio-packaging.md,low,0
Squirrel.Windows,1076,1,334,added,334,0,src/StubExecutable/SplashImageUtils.cpp,high,1
Squirrel.Windows,1076,1,4,added,4,0,src/StubExecutable/SplashImageUtils.h,high,1
Squirrel.Windows,1076,1,20,modified,19,1,src/StubExecutable/StubExecutable.cpp,high,1
Squirrel.Windows,1076,1,4,modified,4,0,src/StubExecutable/StubExecutable.vcxproj,medium,3
Squirrel.Windows,1076,1,6,modified,6,0,src/StubExecutable/StubExecutable.vcxproj.filters,medium,1
Squirrel.Windows,1076,1,6,modified,5,1,src/StubExecutable/stdafx.h,high,1
Squirrel.Windows,1074,1,11,modified,9,2,src/Update/AnimatedGifWindowWinForms.cs,high,2
Squirrel.Windows,1072,1,8,modified,4,4,src/Update/Update.csproj,low,3
Squirrel.Windows,1067,2,4,modified,3,1,docs/using/squirrel-command-line.md,low,1
Squirrel.Windows,1067,2,7,modified,7,0,src/Setup/FxHelper.cpp,high,2
Squirrel.Windows,1067,2,1,modified,1,0,src/Setup/FxHelper.h,high,1
Squirrel.Windows,1067,2,0,modified,0,0,src/Setup/Setup.rc,low,2
Squirrel.Windows,1067,2,1,modified,1,0,src/Setup/Setup.vcxproj,medium,3
Squirrel.Windows,1067,2,3,modified,3,0,src/Setup/Setup.vcxproj.filters,medium,2
Squirrel.Windows,1067,2,12,modified,10,2,src/Setup/UpdateRunner.cpp,high,2
Squirrel.Windows,1067,2,2,modified,1,1,src/Setup/UpdateRunner.h,high,1
Squirrel.Windows,1067,2,0,added,0,0,src/Setup/install_.bin,low,1
Squirrel.Windows,1061,7,7,modified,1,6,src/Update/Update-Mono.csproj,low,0
Squirrel.Windows,1061,7,17,modified,11,6,src/Update/Update.csproj,low,3
Squirrel.Windows,1061,7,1,modified,0,1,src/Update/packages.config,medium,0
Squirrel.Windows,1057,0,2,modified,1,1,src/Squirrel.nuspec,medium,1
Squirrel.Windows,1055,0,20,modified,20,0,src/Setup/FxHelper.cpp,high,2
Squirrel.Windows,1055,0,2,modified,1,1,src/Setup/FxHelper.h,high,1
Squirrel.Windows,1055,0,0,modified,0,0,src/Setup/Setup.rc,low,2
Squirrel.Windows,1055,0,0,modified,0,0,src/Setup/resource.h,high,2
Squirrel.Windows,1054,1,24,modified,21,3,src/Update/Program.cs,high,6
Squirrel.Windows,1051,4,10,modified,10,0,src/Squirrel/Utility.cs,high,0
Squirrel.Windows,1051,4,3,modified,2,1,src/Update/Program.cs,high,6
Squirrel.Windows,1051,4,12,modified,12,0,test/UtilityTests.cs,high,0
Squirrel.Windows,1049,1,1,modified,1,0,src/Squirrel.nuspec,medium,1
Squirrel.Windows,1047,1,32,modified,26,6,src/Squirrel/ReleasePackage.cs,high,0
Squirrel.Windows,1043,1,8,modified,4,4,src/Squirrel/Utility.cs,high,0
Squirrel.Windows,1039,10,1,modified,1,0,src/Squirrel.nuspec,medium,1
Squirrel.Windows,1039,10,61,modified,30,31,src/Squirrel/DeltaPackage.cs,high,1
Squirrel.Windows,1039,10,46,modified,5,41,src/Squirrel/ReleasePackage.cs,high,0
Squirrel.Windows,1039,10,68,modified,68,0,src/Squirrel/Utility.cs,high,0
Squirrel.Windows,1039,10,31,modified,9,22,src/Update/Program.cs,high,6
Squirrel.Windows,1039,10,0,added,0,0,vendor/7zip/7z.dll,high,0
Squirrel.Windows,1039,10,0,added,0,0,vendor/7zip/7z.exe,medium,0
Squirrel.Windows,1037,0,7,modified,6,1,src/Squirrel/ReleaseEntry.cs,high,0
Squirrel.Windows,1037,0,25,modified,25,0,test/ReleaseEntryTests.cs,high,0
Squirrel.Windows,1023,1,2,modified,1,1,vendor/wix/template.wxs,medium,0
Squirrel.Windows,1017,1,22,modified,11,11,src/Squirrel/UpdateManager.ApplyReleases.cs,high,4
Squirrel.Windows,1017,1,39,modified,27,12,src/Squirrel/Utility.cs,high,1
Squirrel.Windows,1016,1,9,modified,5,4,src/StubExecutable/StubExecutable.cpp,high,1
Squirrel.Windows,1012,1,31,modified,27,4,docs/using/visual-studio-packaging.md,low,0
Squirrel.Windows,1004,0,4,modified,2,2,docs/faq.md,low,0
Squirrel.Windows,1001,1,2,modified,1,1,src/Squirrel/UpdateInfo.cs,high,0
Squirrel.Windows,993,1,4,modified,2,2,docs/faq.md,low,1
Squirrel.Windows,991,1,36,modified,18,18,docs/contributing/vs-solution-overview.md,low,0
Squirrel.Windows,990,3,37,modified,17,20,docs/faq.md,low,1
Squirrel.Windows,980,1,2,modified,1,1,README.md,low,1
Squirrel.Windows,976,1,30,modified,28,2,docs/using/visual-studio-packaging.md,low,0
Squirrel.Windows,972,2,6,modified,5,1,src/Squirrel/FileDownloader.cs,high,0
Squirrel.Windows,972,2,1,modified,1,0,src/Squirrel/UpdateManager.ApplyReleases.cs,high,4
Squirrel.Windows,961,7,1,modified,0,1,src/Setup/UpdateRunner.cpp,high,2
Squirrel.Windows,961,7,9,modified,3,6,src/Squirrel/BinaryPatchUtility.cs,high,0
Squirrel.Windows,961,7,2,modified,1,1,src/Squirrel/IUpdateManager.cs,high,1
Squirrel.Windows,961,7,34,modified,17,17,src/Squirrel/NativeMethods.cs,high,0
Squirrel.Windows,961,7,10,modified,5,5,src/Squirrel/ShellFile.cs,high,0
Squirrel.Windows,961,7,2,modified,1,1,src/Squirrel/SquirrelAwareExecutableDetector.cs,high,1
Squirrel.Windows,961,7,2,modified,1,1,src/Squirrel/Utility.cs,high,1
Squirrel.Windows,955,1,2,modified,1,1,src/Squirrel/SquirrelAwareApp.cs,high,0
Squirrel.Windows,951,6,45,modified,44,1,src/Squirrel/UpdateManager.ApplyReleases.cs,high,4
Squirrel.Windows,951,6,36,modified,36,0,src/Squirrel/Utility.cs,high,1
Squirrel.Windows,951,6,31,modified,28,3,src/StubExecutable/StubExecutable.cpp,high,1
Squirrel.Windows,951,6,78,modified,75,3,src/Update/Program.cs,high,6
Squirrel.Windows,949,1,5,modified,5,0,src/SyncReleases/SyncImplementations.cs,high,0
Squirrel.Windows,948,0,2,modified,2,0,src/Update/Program.cs,high,6
Squirrel.Windows,942,0,117,modified,111,6,docs/using/visual-studio-packaging.md,low,0
Squirrel.Windows,940,5,106,modified,88,18,src/Setup/FxHelper.cpp,high,2
Squirrel.Windows,940,5,12,modified,10,2,src/Setup/FxHelper.h,high,1
Squirrel.Windows,940,5,0,modified,0,0,src/Setup/Setup.rc,low,2
Squirrel.Windows,940,5,3,modified,2,1,src/Setup/Setup.vcxproj,medium,3
Squirrel.Windows,940,5,3,modified,3,0,src/Setup/Setup.vcxproj.filters,medium,2
Squirrel.Windows,940,5,0,added,0,0,src/Setup/flags1.bin,low,0
Squirrel.Windows,940,5,0,modified,0,0,src/Setup/resource.h,high,2
Squirrel.Windows,940,5,8,modified,5,3,src/Setup/winmain.cpp,high,2
Squirrel.Windows,940,5,9,modified,6,3,src/Update/Program.cs,high,6
Squirrel.Windows,940,5,13,modified,11,2,src/WriteZipToSetup/WriteZipToSetup.cpp,high,2
Squirrel.Windows,935,11,8,modified,8,0,src/Squirrel/ReleasePackage.cs,high,0
Squirrel.Windows,935,11,13,modified,11,2,src/Squirrel/Utility.cs,high,1
Squirrel.Windows,935,11,8,modified,7,1,src/StubExecutable/StubExecutable.cpp,high,1
Squirrel.Windows,935,11,230,added,230,0,src/Update/AuthenticodeTools.cs,high,0
Squirrel.Windows,935,11,42,modified,30,12,src/Update/Program.cs,high,6
Squirrel.Windows,935,11,1,modified,1,0,src/Update/Update.csproj,low,3
Squirrel.Windows,935,11,9,modified,9,0,test/ReleasePackageTests.cs,high,0
Squirrel.Windows,935,11,11,modified,11,0,test/UtilityTests.cs,high,0
Squirrel.Windows,933,1,2,modified,1,1,docs/using/nuget-package-metadata.md,low,0
Squirrel.Windows,932,1,15,modified,9,6,src/Squirrel/UpdateManager.ApplyReleases.cs,high,4
Squirrel.Windows,928,4,71,modified,67,4,src/Squirrel/SquirrelAwareApp.cs,high,0
Squirrel.Windows,926,3,25,modified,18,7,src/Update/Program.cs,high,6
Squirrel.Windows,926,3,6,modified,3,3,src/Update/Update.csproj,low,3
Squirrel.Windows,924,1,2,modified,1,1,src/Squirrel/ReleaseExtensions.cs,high,0
Squirrel.Windows,922,1,4,modified,3,1,src/StubExecutable/StubExecutable.cpp,high,1
Squirrel.Windows,889,1,5,modified,4,1,src/Update/Program.cs,high,6
Squirrel.Windows,886,0,13,modified,9,4,src/Squirrel/FileDownloader.cs,high,0
WindowsIcons,221,1,0,renamed,0,0,WindowsPhone/license.md,low,0
WindowsIcons,221,1,0,renamed,0,0,WindowsRT/license.md,low,0
WindowsIcons,211,2,5,added,5,0,WindowsPhone/svg/appbar.dock.window.svg,medium,0
WindowsIcons,210,1,2,modified,1,1,WindowsPhone/license.txt,low,1
WindowsIcons,201,1,2,modified,1,1,WindowsPhone/xaml/appbar.table.unselect.xaml,medium,0
WindowsIcons,199,0,0,renamed,0,0,WindowsPhone/dark/appbar.drinks.beer.guinness.png,low,0
WindowsIcons,199,0,0,renamed,0,0,WindowsPhone/dark/appbar.drinks.beer.png,low,0
WindowsIcons,199,0,0,renamed,0,0,WindowsPhone/dark/appbar.drinks.martini.png,low,0
WindowsIcons,199,0,0,renamed,0,0,WindowsPhone/dark/appbar.food.candy.cane.png,low,0
WindowsIcons,199,0,0,renamed,0,0,WindowsPhone/design/appbar.drinks.beer.design,NaN,0
WindowsIcons,199,0,0,renamed,0,0,WindowsPhone/design/appbar.drinks.beer.guinness.design,NaN,0
WindowsIcons,199,0,0,renamed,0,0,WindowsPhone/design/appbar.drinks.martini.design,NaN,0
WindowsIcons,199,0,0,renamed,0,0,WindowsPhone/design/appbar.food.candy.cane.design,NaN,0
WindowsIcons,199,0,0,renamed,0,0,WindowsPhone/light/appbar.drinks.beer.guinness.png,low,0
WindowsIcons,199,0,0,renamed,0,0,WindowsPhone/light/appbar.drinks.beer.png,low,0
WindowsIcons,199,0,0,renamed,0,0,WindowsPhone/light/appbar.drinks.martini.png,low,0
WindowsIcons,199,0,0,renamed,0,0,WindowsPhone/light/appbar.food.candy.cane.png,low,0
WindowsIcons,199,0,0,renamed,0,0,WindowsPhone/svg/appbar.drinks.beer.guinness.svg,medium,0
WindowsIcons,199,0,0,renamed,0,0,WindowsPhone/svg/appbar.drinks.beer.svg,medium,0
WindowsIcons,199,0,0,renamed,0,0,WindowsPhone/svg/appbar.drinks.martini.svg,medium,0
WindowsIcons,199,0,0,renamed,0,0,WindowsPhone/svg/appbar.food.candy.cane.svg,medium,0
WindowsIcons,199,0,0,renamed,0,0,WindowsPhone/xaml/appbar.drinks.beer.guinness.xaml,medium,0
WindowsIcons,199,0,0,renamed,0,0,WindowsPhone/xaml/appbar.drinks.beer.xaml,medium,0
WindowsIcons,199,0,0,renamed,0,0,WindowsPhone/xaml/appbar.drinks.martini.xaml,medium,0
WindowsIcons,199,0,0,renamed,0,0,WindowsPhone/xaml/appbar.food.candy.cane.xaml,medium,0
WindowsIcons,198,0,0,renamed,0,0,WindowsPhone/dark/appbar.food.cupcake.png,low,0
WindowsIcons,198,0,0,renamed,0,0,WindowsPhone/dark/appbar.food.icecream.bar.png,low,0
WindowsIcons,198,0,0,renamed,0,0,WindowsPhone/design/appbar.food.cupcake.design,NaN,0
WindowsIcons,198,0,0,renamed,0,0,WindowsPhone/design/appbar.food.icecream.bar.design,NaN,0
WindowsIcons,198,0,0,renamed,0,0,WindowsPhone/light/appbar.food.cupcake.png,low,0
WindowsIcons,198,0,0,renamed,0,0,WindowsPhone/light/appbar.food.icecream.bar.png,low,0
WindowsIcons,198,0,0,renamed,0,0,WindowsPhone/svg/appbar.food.cupcake.svg,medium,0
WindowsIcons,198,0,0,renamed,0,0,WindowsPhone/svg/appbar.food.icecream.bar.svg,medium,0
WindowsIcons,198,0,0,renamed,0,0,WindowsPhone/xaml/appbar.food.cupcake.xaml,medium,0
WindowsIcons,198,0,0,renamed,0,0,WindowsPhone/xaml/appbar.food.icecream.bar.xaml,medium,0
WindowsIcons,197,0,0,renamed,0,0,WindowsPhone/dark/appbar.connection.nfc.png,low,0
WindowsIcons,197,0,0,renamed,0,0,WindowsPhone/design/appbar.connection.nfc.design,NaN,0
WindowsIcons,197,0,0,renamed,0,0,WindowsPhone/light/appbar.connection.nfc.png,low,0
WindowsIcons,197,0,0,renamed,0,0,WindowsPhone/svg/appbar.connection.nfc.svg,medium,0
WindowsIcons,197,0,0,renamed,0,0,WindowsPhone/xaml/appbar.connection.nfc.xaml,medium,0
WindowsIcons,194,1,0,added,0,0,WindowsPhone/dark/appbar.3ds.png,low,0
WindowsIcons,194,1,0,added,0,0,WindowsPhone/dark/appbar.collada.png,low,0
WindowsIcons,194,1,0,added,0,0,WindowsPhone/dark/appbar.obj.png,low,0
WindowsIcons,194,1,0,added,0,0,WindowsPhone/design/appbar.3ds.design,NaN,0
WindowsIcons,194,1,0,added,0,0,WindowsPhone/design/appbar.collada.design,NaN,0
WindowsIcons,194,1,0,added,0,0,WindowsPhone/design/appbar.obj.design,NaN,0
WindowsIcons,180,1,0,renamed,0,0,WindowsPhone/dark/appbar.onedrive.download.png,low,1
WindowsIcons,180,1,0,renamed,0,0,WindowsPhone/dark/appbar.onedrive.png,low,1
WindowsIcons,180,1,0,renamed,0,0,WindowsPhone/dark/appbar.onedrive.upload.png,low,1
WindowsIcons,180,1,0,renamed,0,0,WindowsPhone/design/appbar.onedrive.design,NaN,1
WindowsIcons,180,1,0,renamed,0,0,WindowsPhone/design/appbar.onedrive.download.design,NaN,1
WindowsIcons,180,1,0,renamed,0,0,WindowsPhone/design/appbar.onedrive.upload.design,NaN,1
WindowsIcons,180,1,0,renamed,0,0,WindowsPhone/design/appbar.social.onedrive.design,NaN,1
WindowsIcons,180,1,0,renamed,0,0,WindowsPhone/light/appbar.onedrive.download.png,low,1
WindowsIcons,180,1,0,renamed,0,0,WindowsPhone/light/appbar.onedrive.png,low,1
WindowsIcons,180,1,0,renamed,0,0,WindowsPhone/light/appbar.onedrive.upload.png,low,1
WindowsIcons,180,1,0,renamed,0,0,WindowsPhone/svg/appbar.onedrive.download.svg,medium,1
WindowsIcons,180,1,0,renamed,0,0,WindowsPhone/svg/appbar.onedrive.svg,medium,1
WindowsIcons,180,1,0,renamed,0,0,WindowsPhone/svg/appbar.onedrive.upload.svg,medium,1
WindowsIcons,180,1,2,renamed,1,1,WindowsPhone/xaml/appbar.onedrive.download.xaml,medium,1
WindowsIcons,180,1,2,renamed,1,1,WindowsPhone/xaml/appbar.onedrive.upload.xaml,medium,1
WindowsIcons,180,1,2,renamed,1,1,WindowsPhone/xaml/appbar.onedrive.xaml,medium,1
WindowsIcons,147,3,0,added,0,0,WindowsPhone/design/appbar.newspaper.new.design,NaN,1
WindowsIcons,143,1,0,added,0,0,WindowsPhone/design/appbar.tablet.windows.design,NaN,0
WindowsIcons,128,1,0,modified,0,0,WindowsPhone/design/appbar.windowsphone.design,NaN,0
WindowsIcons,114,0,2,modified,1,1,WindowsPhone/xaml/appbar.book.hardcover.open.xaml,medium,0
WindowsIcons,114,0,2,modified,1,1,WindowsPhone/xaml/appbar.book.perspective.xaml,medium,0
WindowsIcons,114,0,2,modified,1,1,WindowsPhone/xaml/appbar.card.1.xaml,medium,0
WindowsIcons,114,0,2,modified,1,1,WindowsPhone/xaml/appbar.card.3.xaml,medium,0
WindowsIcons,114,0,2,modified,1,1,WindowsPhone/xaml/appbar.card.4.xaml,medium,0
WindowsIcons,114,0,2,modified,1,1,WindowsPhone/xaml/appbar.card.5.xaml,medium,0
WindowsIcons,114,0,2,modified,1,1,WindowsPhone/xaml/appbar.card.6.xaml,medium,0
WindowsIcons,114,0,2,modified,1,1,WindowsPhone/xaml/appbar.card.7.xaml,medium,0
WindowsIcons,114,0,2,modified,1,1,WindowsPhone/xaml/appbar.card.8.xaml,medium,0
WindowsIcons,114,0,2,modified,1,1,WindowsPhone/xaml/appbar.card.9.xaml,medium,0
WindowsIcons,114,0,2,modified,1,1,WindowsPhone/xaml/appbar.card.xaml,medium,0
WindowsIcons,114,0,2,modified,1,1,WindowsPhone/xaml/appbar.dimension.arrow.box.height.xaml,medium,0
WindowsIcons,114,0,2,modified,1,1,WindowsPhone/xaml/appbar.dimension.arrow.box.width.xaml,medium,0
WindowsIcons,114,0,2,modified,1,1,WindowsPhone/xaml/appbar.dimension.arrow.line.height.short.xaml,medium,0
WindowsIcons,114,0,2,modified,1,1,WindowsPhone/xaml/appbar.dimension.arrow.line.height.thick.xaml,medium,0
WindowsIcons,114,0,2,modified,1,1,WindowsPhone/xaml/appbar.dimension.arrow.line.height.xaml,medium,0
WindowsIcons,114,0,2,modified,1,1,WindowsPhone/xaml/appbar.dimension.arrow.line.width.short.xaml,medium,0
WindowsIcons,114,0,2,modified,1,1,WindowsPhone/xaml/appbar.dimension.arrow.line.width.xaml,medium,0
WindowsIcons,114,0,2,modified,1,1,WindowsPhone/xaml/appbar.marketplace.old.xaml,medium,0
WindowsIcons,114,0,2,modified,1,1,WindowsPhone/xaml/appbar.page.0.xaml,medium,0
WindowsIcons,114,0,2,modified,1,1,WindowsPhone/xaml/appbar.page.1.xaml,medium,0
WindowsIcons,114,0,2,modified,1,1,WindowsPhone/xaml/appbar.page.2.xaml,medium,0
WindowsIcons,114,0,2,modified,1,1,WindowsPhone/xaml/appbar.page.3.xaml,medium,0
WindowsIcons,114,0,2,modified,1,1,WindowsPhone/xaml/appbar.page.4.xaml,medium,0
WindowsIcons,114,0,2,modified,1,1,WindowsPhone/xaml/appbar.page.5.xaml,medium,0
WindowsIcons,114,0,2,modified,1,1,WindowsPhone/xaml/appbar.page.6.xaml,medium,0
WindowsIcons,114,0,2,modified,1,1,WindowsPhone/xaml/appbar.page.7.xaml,medium,0
WindowsIcons,114,0,2,modified,1,1,WindowsPhone/xaml/appbar.page.8.xaml,medium,0
WindowsIcons,114,0,2,modified,1,1,WindowsPhone/xaml/appbar.page.9.xaml,medium,0
WindowsIcons,114,0,2,modified,1,1,WindowsPhone/xaml/appbar.page.corner.folded.text.xaml,medium,0
samples,544,2,0,renamed,0,0,GpioOneWire/CPP/App.xaml,medium,0
samples,544,2,0,renamed,0,0,GpioOneWire/CPP/App.xaml.cpp,high,0
samples,544,2,0,renamed,0,0,GpioOneWire/CPP/App.xaml.h,high,0
samples,544,2,0,renamed,0,0,GpioOneWire/CPP/Assets/LockScreenLogo.scale-200.png,low,0
samples,544,2,0,renamed,0,0,GpioOneWire/CPP/Assets/SplashScreen.scale-200.png,low,0
samples,544,2,0,renamed,0,0,GpioOneWire/CPP/Assets/Square150x150Logo.scale-200.png,low,0
samples,544,2,0,renamed,0,0,GpioOneWire/CPP/Assets/Square44x44Logo.scale-200.png,low,0
samples,544,2,0,renamed,0,0,GpioOneWire/CPP/Assets/Square44x44Logo.targetsize-24_altform-unplated.png,low,0
samples,544,2,0,renamed,0,0,GpioOneWire/CPP/Assets/StoreLogo.png,low,0
samples,544,2,0,renamed,0,0,GpioOneWire/CPP/Assets/Wide310x150Logo.scale-200.png,low,0
samples,544,2,0,renamed,0,0,GpioOneWire/CPP/GpioOneWire.vcxproj,medium,0
samples,544,2,0,renamed,0,0,GpioOneWire/CPP/GpioOneWire.vcxproj.filters,medium,0
samples,544,2,0,renamed,0,0,GpioOneWire/CPP/GpioOneWire_TemporaryKey.pfx,low,0
samples,544,2,0,renamed,0,0,GpioOneWire/CPP/MainPage.xaml,medium,0
samples,544,2,0,renamed,0,0,GpioOneWire/CPP/MainPage.xaml.cpp,high,0
samples,544,2,15,renamed,12,3,GpioOneWire/CPP/MainPage.xaml.h,high,0
samples,544,2,0,renamed,0,0,GpioOneWire/CPP/Package.appxmanifest,medium,0
samples,544,2,0,renamed,0,0,GpioOneWire/CPP/pch.cpp,high,0
samples,544,2,0,renamed,0,0,GpioOneWire/CPP/pch.h,high,0
samples,544,2,8,added,8,0,GpioOneWire/CS/App.xaml,medium,0
samples,544,2,100,added,100,0,GpioOneWire/CS/App.xaml.cs,high,0
samples,544,2,0,added,0,0,GpioOneWire/CS/Assets/LockScreenLogo.scale-200.png,low,0
samples,544,2,0,added,0,0,GpioOneWire/CS/Assets/SplashScreen.scale-200.png,low,0
samples,544,2,0,added,0,0,GpioOneWire/CS/Assets/Square150x150Logo.scale-200.png,low,0
samples,544,2,0,added,0,0,GpioOneWire/CS/Assets/Square44x44Logo.scale-200.png,low,0
samples,544,2,0,added,0,0,GpioOneWire/CS/Assets/Square44x44Logo.targetsize-24_altform-unplated.png,low,0
samples,544,2,0,added,0,0,GpioOneWire/CS/Assets/StoreLogo.png,low,0
samples,544,2,0,added,0,0,GpioOneWire/CS/Assets/Wide310x150Logo.scale-200.png,low,0
samples,544,2,69,added,69,0,GpioOneWire/CS/DhtSensorReading.cs,high,0
samples,544,2,146,added,146,0,GpioOneWire/CS/GpioOneWire.csproj,low,0
samples,542,1,9,modified,6,3,IotOnboarding/IoTOnboardingService/OnboardingAccessPoint.cs,high,0
samples,539,1,22,modified,3,19,README.md,low,1
samples,538,50,8,modified,6,2,.gitignore,low,1
samples,538,50,4,modified,2,2,AirHockeyRobot/AirHockeyApp/AirHockeyApp.csproj,low,1
samples,538,50,0,modified,0,0,AirHockeyRobot/AirHockeyApp/AirHockeyApp_TemporaryKey.pfx,low,1
samples,538,50,4,modified,2,2,AirHockeyRobot/AirHockeyHelper/AirHockeyHelper.csproj,low,1
samples,538,50,2,modified,1,1,AllJoyn/Platform/BackgroundHost/BackgroundHost.Headed/BackgroundHost.Headed.vcxproj,medium,1
samples,538,50,2,modified,1,1,AllJoyn/Platform/BackgroundHost/BackgroundHost.Headless/BackgroundHost.Headless.vcxproj,medium,1
samples,538,50,2,modified,1,1,AllJoyn/Platform/BackgroundHost/BackgroundHost/BackgroundHost.vcxproj,medium,1
samples,538,50,2,modified,1,1,AllJoyn/Platform/BridgeRT/BridgeRT.vcxproj,medium,1
samples,538,50,14,modified,7,7,AllJoyn/Platform/DeviceProviders/DeviceProviders.vcxproj,medium,1
samples,538,50,14,modified,7,7,AllJoyn/Samples/AllJoyn.JS/Runtime/ajtcl/ajtcl.vcxproj,medium,1
samples,538,50,14,modified,7,7,AllJoyn/Samples/AllJoyn.JS/Runtime/alljoyn-js/alljoyn-js.vcxproj,medium,1
samples,538,50,18,modified,9,9,AllJoyn/Samples/AllJoyn.JS/UWP/BackgroundService/AllJoynJSBackgroundService.vcxproj,medium,1
samples,538,50,0,modified,0,0,AllJoyn/Samples/AllJoyn.JS/UWP/BackgroundService/AllJoynJSBackgroundService_TemporaryKey.pfx,low,1
samples,538,50,14,modified,7,7,AllJoyn/Samples/AllJoyn.JS/UWP/HostApp/AllJoynJSHostApp.vcxproj,medium,1
samples,538,50,0,modified,0,0,AllJoyn/Samples/AllJoyn.JS/UWP/HostApp/AllJoynJSHostApp_TemporaryKey.pfx,low,1
samples,538,50,4,modified,2,2,AllJoyn/Samples/AllJoynVoice/AllJoynVoice/AllJoynVoice.csproj,low,1
samples,538,50,0,modified,0,0,AllJoyn/Samples/AllJoynVoice/AllJoynVoice/AllJoynVoice_TemporaryKey.pfx,low,1
samples,538,50,10,modified,5,5,AllJoyn/Samples/BACnetAdapter/AdapterLib/AdapterLib.vcxproj,medium,1
samples,538,50,14,modified,7,7,AllJoyn/Samples/BACnetAdapter/BACnetRuntime/BACnet_Handler_Library/BACnet_Handler_Library.vcxproj,medium,1
samples,538,50,14,modified,7,7,AllJoyn/Samples/BACnetAdapter/BACnetRuntime/BACnet_Stack_Library/BACnet_Stack_Library.vcxproj,medium,1
samples,538,50,10,modified,5,5,AllJoyn/Samples/BACnetAdapter/HeadedAdapterApp/HeadedAdapterApp.vcxproj,medium,1
samples,538,50,0,modified,0,0,AllJoyn/Samples/BACnetAdapter/HeadedAdapterApp/HeadedAdapterApp_TemporaryKey.pfx,low,1
samples,538,50,10,modified,5,5,AllJoyn/Samples/BACnetAdapter/HeadlessAdapterApp/HeadlessAdapterApp.vcxproj,medium,1
samples,538,50,0,modified,0,0,AllJoyn/Samples/BACnetAdapter/HeadlessAdapterApp/HeadlessAdapterApp_TemporaryKey.pfx,low,1
samples,538,50,10,modified,5,5,AllJoyn/Samples/BACnetAdapter/bacnet-stack-0.8.2/ports/win32/Microsoft Visual Studio 2015/BACnet_Handler_Library/BACnet_Handler_Library.vcxproj,medium,1
samples,538,50,10,modified,5,5,AllJoyn/Samples/BACnetAdapter/bacnet-stack-0.8.2/ports/win32/Microsoft Visual Studio 2015/BACnet_Object_Definitions/BACnet_Object_Definitions.vcxproj,medium,1
samples,538,50,10,modified,5,5,AllJoyn/Samples/BACnetAdapter/bacnet-stack-0.8.2/ports/win32/Microsoft Visual Studio 2015/BACnet_Stack_Library/BACnet_Stack_Library.vcxproj,medium,1
samples,538,50,14,modified,7,7,AllJoyn/Samples/MockAdapter/AdapterLib/AdapterLib.vcxproj,medium,1
samples,538,50,14,modified,7,7,AllJoyn/Samples/MockAdapter/HeadedAdapterApp/HeadedAdapterApp.vcxproj,medium,1
samples,538,50,0,modified,0,0,AllJoyn/Samples/MockAdapter/HeadedAdapterApp/HeadedAdapterApp_TemporaryKey.pfx,low,1
samples,536,1,1,modified,1,0,.gitignore,low,1
samples,536,1,10,modified,0,10,BlinkyServer/Python/PythonBlinkyServer/Package.appxmanifest,medium,0
samples,536,1,21,modified,5,16,BlinkyServer/Python/PythonBlinkyServer/PythonBlinkyServer.pyproj,high,0
samples,536,1,7,modified,5,2,BlinkyServer/Python/PythonBlinkyServer/PythonBlinkyServer.sln,low,0
samples,536,1,0,removed,0,0,BlinkyServer/Python/PythonBlinkyServer/windevices/ARM/Microsoft.IoT.Lightning.Providers.dll,high,0
samples,536,1,0,modified,0,0,BlinkyServer/Python/PythonBlinkyServer/windevices/ARM/_wingpio.pyd,NaN,0
samples,536,1,0,modified,0,0,BlinkyServer/Python/PythonBlinkyServer/windevices/ARM/_wingpio_d.pyd,NaN,0
samples,536,1,0,removed,0,0,BlinkyServer/Python/PythonBlinkyServer/windevices/win32/Microsoft.IoT.Lightning.Providers.dll,high,0
samples,536,1,0,modified,0,0,BlinkyServer/Python/PythonBlinkyServer/windevices/win32/_wingpio.pyd,NaN,0
samples,536,1,0,modified,0,0,BlinkyServer/Python/PythonBlinkyServer/windevices/win32/_wingpio_d.pyd,NaN,0
samples,536,1,0,removed,0,0,BlinkyServer/Python/PythonBlinkyServer/windevices/x64/Microsoft.IoT.Lightning.Providers.dll,high,0
samples,536,1,0,modified,0,0,BlinkyServer/Python/PythonBlinkyServer/windevices/x64/_wingpio.pyd,NaN,0
samples,536,1,0,modified,0,0,BlinkyServer/Python/PythonBlinkyServer/windevices/x64/_wingpio_d.pyd,NaN,0
samples,536,1,7,modified,5,2,GoPiGoXbox/GoPiGoXboxWebService/GoPiGoXboxWebService.sln,low,0
samples,536,1,17,modified,5,12,GoPiGoXbox/GoPiGoXboxWebService/GoPiGoXboxWebService/GoPiGoXboxWebService.pyproj,high,0
samples,536,1,0,removed,0,0,GoPiGoXbox/GoPiGoXboxWebService/GoPiGoXboxWebService/Lightning.dll,high,0
samples,536,1,0,removed,0,0,GoPiGoXbox/GoPiGoXboxWebService/GoPiGoXboxWebService/Microsoft.IoT.Lightning.Providers.dll,high,0
samples,536,1,10,modified,0,10,GoPiGoXbox/GoPiGoXboxWebService/GoPiGoXboxWebService/Package.appxmanifest,medium,0
samples,536,1,0,modified,0,0,GoPiGoXbox/GoPiGoXboxWebService/GoPiGoXboxWebService/_wini2c.pyd,NaN,0
samples,536,1,10,modified,0,10,HelloBlinkyBackground/Python/Package.appxmanifest,medium,0
samples,536,1,21,modified,5,16,HelloBlinkyBackground/Python/PythonBlinkyHeadless.pyproj,high,0
samples,536,1,7,modified,5,2,HelloBlinkyBackground/Python/PythonBlinkyHeadless.sln,low,0
samples,536,1,0,removed,0,0,HelloBlinkyBackground/Python/windevices/ARM/Microsoft.IoT.Lightning.Providers.dll,high,0
samples,536,1,0,modified,0,0,HelloBlinkyBackground/Python/windevices/ARM/_wingpio.pyd,NaN,0
samples,536,1,0,modified,0,0,HelloBlinkyBackground/Python/windevices/ARM/_wingpio_d.pyd,NaN,0
samples,536,1,0,removed,0,0,HelloBlinkyBackground/Python/windevices/win32/Microsoft.IoT.Lightning.Providers.dll,high,0
samples,536,1,0,modified,0,0,HelloBlinkyBackground/Python/windevices/win32/_wingpio.pyd,NaN,0
samples,536,1,0,modified,0,0,HelloBlinkyBackground/Python/windevices/win32/_wingpio_d.pyd,NaN,0
samples,536,1,0,removed,0,0,HelloBlinkyBackground/Python/windevices/x64/Microsoft.IoT.Lightning.Providers.dll,high,0
samples,536,1,0,modified,0,0,HelloBlinkyBackground/Python/windevices/x64/_wingpio.pyd,NaN,0
samples,535,1,3,modified,1,2,HIDInjector/app/HidInject.cpp,high,0
samples,535,1,2,modified,1,1,HIDInjector/app/HidInject.h,high,0
samples,535,1,4,modified,2,2,HIDInjector/app/SendInput.cpp,high,0
samples,534,50,8,modified,6,2,.gitignore,low,2
samples,534,50,4,modified,2,2,AirHockeyRobot/AirHockeyApp/AirHockeyApp.csproj,low,2
samples,534,50,0,modified,0,0,AirHockeyRobot/AirHockeyApp/AirHockeyApp_TemporaryKey.pfx,low,2
samples,534,50,4,modified,2,2,AirHockeyRobot/AirHockeyHelper/AirHockeyHelper.csproj,low,2
samples,534,50,2,modified,1,1,AllJoyn/Platform/BackgroundHost/BackgroundHost.Headed/BackgroundHost.Headed.vcxproj,medium,2
samples,534,50,2,modified,1,1,AllJoyn/Platform/BackgroundHost/BackgroundHost.Headless/BackgroundHost.Headless.vcxproj,medium,2
samples,534,50,2,modified,1,1,AllJoyn/Platform/BackgroundHost/BackgroundHost/BackgroundHost.vcxproj,medium,2
samples,534,50,2,modified,1,1,AllJoyn/Platform/BridgeRT/BridgeRT.vcxproj,medium,2
samples,534,50,14,modified,7,7,AllJoyn/Platform/DeviceProviders/DeviceProviders.vcxproj,medium,2
samples,534,50,14,modified,7,7,AllJoyn/Samples/AllJoyn.JS/Runtime/ajtcl/ajtcl.vcxproj,medium,2
samples,534,50,14,modified,7,7,AllJoyn/Samples/AllJoyn.JS/Runtime/alljoyn-js/alljoyn-js.vcxproj,medium,2
samples,534,50,18,modified,9,9,AllJoyn/Samples/AllJoyn.JS/UWP/BackgroundService/AllJoynJSBackgroundService.vcxproj,medium,2
samples,534,50,0,modified,0,0,AllJoyn/Samples/AllJoyn.JS/UWP/BackgroundService/AllJoynJSBackgroundService_TemporaryKey.pfx,low,2
samples,534,50,14,modified,7,7,AllJoyn/Samples/AllJoyn.JS/UWP/HostApp/AllJoynJSHostApp.vcxproj,medium,2
samples,534,50,0,modified,0,0,AllJoyn/Samples/AllJoyn.JS/UWP/HostApp/AllJoynJSHostApp_TemporaryKey.pfx,low,2
samples,534,50,4,modified,2,2,AllJoyn/Samples/AllJoynVoice/AllJoynVoice/AllJoynVoice.csproj,low,2
samples,534,50,0,modified,0,0,AllJoyn/Samples/AllJoynVoice/AllJoynVoice/AllJoynVoice_TemporaryKey.pfx,low,2
samples,534,50,10,modified,5,5,AllJoyn/Samples/BACnetAdapter/AdapterLib/AdapterLib.vcxproj,medium,2
samples,534,50,14,modified,7,7,AllJoyn/Samples/BACnetAdapter/BACnetRuntime/BACnet_Handler_Library/BACnet_Handler_Library.vcxproj,medium,2
samples,534,50,14,modified,7,7,AllJoyn/Samples/BACnetAdapter/BACnetRuntime/BACnet_Stack_Library/BACnet_Stack_Library.vcxproj,medium,2
samples,534,50,10,modified,5,5,AllJoyn/Samples/BACnetAdapter/HeadedAdapterApp/HeadedAdapterApp.vcxproj,medium,2
samples,534,50,0,modified,0,0,AllJoyn/Samples/BACnetAdapter/HeadedAdapterApp/HeadedAdapterApp_TemporaryKey.pfx,low,2
samples,534,50,10,modified,5,5,AllJoyn/Samples/BACnetAdapter/HeadlessAdapterApp/HeadlessAdapterApp.vcxproj,medium,2
samples,534,50,0,modified,0,0,AllJoyn/Samples/BACnetAdapter/HeadlessAdapterApp/HeadlessAdapterApp_TemporaryKey.pfx,low,2
samples,534,50,10,modified,5,5,AllJoyn/Samples/BACnetAdapter/bacnet-stack-0.8.2/ports/win32/Microsoft Visual Studio 2015/BACnet_Handler_Library/BACnet_Handler_Library.vcxproj,medium,2
samples,534,50,10,modified,5,5,AllJoyn/Samples/BACnetAdapter/bacnet-stack-0.8.2/ports/win32/Microsoft Visual Studio 2015/BACnet_Object_Definitions/BACnet_Object_Definitions.vcxproj,medium,2
samples,534,50,10,modified,5,5,AllJoyn/Samples/BACnetAdapter/bacnet-stack-0.8.2/ports/win32/Microsoft Visual Studio 2015/BACnet_Stack_Library/BACnet_Stack_Library.vcxproj,medium,2
samples,534,50,14,modified,7,7,AllJoyn/Samples/MockAdapter/AdapterLib/AdapterLib.vcxproj,medium,2
samples,534,50,14,modified,7,7,AllJoyn/Samples/MockAdapter/HeadedAdapterApp/HeadedAdapterApp.vcxproj,medium,2
samples,534,50,0,modified,0,0,AllJoyn/Samples/MockAdapter/HeadedAdapterApp/HeadedAdapterApp_TemporaryKey.pfx,low,2
samples,533,1,4,modified,2,2,IoTCoreDefaultApp/IoTCoreDefaultApp/App.xaml.cs,high,0
samples,533,1,4,modified,2,2,IoTCoreDefaultApp/IoTCoreDefaultApp/IoTCoreDefaultApp.csproj,low,0
samples,533,1,23,modified,21,2,IoTCoreDefaultApp/IoTCoreDefaultApp/Presenters/ConnectedDevicePresenter.cs,high,0
samples,533,1,6,modified,4,2,IoTCoreDefaultApp/IoTCoreDefaultApp/UserControls/TopBarUC.xaml.cs,high,0
samples,533,1,9,modified,5,4,IoTCoreDefaultApp/IoTCoreDefaultApp/Views/OOBEWelcome.xaml,medium,0
samples,533,1,15,modified,6,9,IoTCoreDefaultApp/IoTCoreDefaultApp/Views/OOBEWelcome.xaml.cs,high,0
samples,533,1,57,modified,29,28,IoTCoreDefaultApp/IoTCoreDefaultApp/Views/Settings.xaml,medium,0
samples,533,1,20,modified,13,7,IoTCoreDefaultApp/IoTCoreDefaultApp/Views/Settings.xaml.cs,high,0
samples,531,1,0,added,0,0,WiFiConnector/CS/Assets/wps-button40x40.png,low,0
samples,531,1,113,modified,108,5,WiFiConnector/CS/DisplayHelpers.cs,high,0
samples,531,1,24,modified,13,11,WiFiConnector/CS/WiFiConnect.csproj,low,0
samples,531,1,246,modified,164,82,WiFiConnector/CS/WiFiConnect_Scenario.xaml,medium,0
samples,531,1,196,modified,174,22,WiFiConnector/CS/WiFiConnect_Scenario.xaml.cs,high,0
samples,531,1,16,removed,0,16,WiFiConnector/CS/project.json,medium,0
samples,528,1,7,modified,6,1,IoTCoreDefaultApp/IoTCoreDefaultApp/App.xaml.cs,high,0
samples,528,1,7,modified,4,3,IoTCoreDefaultApp/IoTCoreDefaultApp/IoTCoreDefaultApp.csproj,low,0
samples,528,1,396,modified,370,26,IoTCoreDefaultApp/IoTCoreDefaultApp/Presenters/LanguageManager.cs,high,0
samples,528,1,2,modified,1,1,IoTCoreDefaultApp/IoTCoreDefaultApp/Presenters/NetworkPresenter.cs,high,0
samples,528,1,12,modified,0,12,IoTCoreDefaultApp/IoTCoreDefaultApp/Strings/ar-SA/Resources.resw,NaN,0
samples,528,1,21,modified,21,0,IoTCoreDefaultApp/IoTCoreDefaultApp/Strings/en-US/Resources.resw,NaN,0
samples,528,1,12,modified,0,12,IoTCoreDefaultApp/IoTCoreDefaultApp/Strings/nl-NL/Resources.resw,NaN,0
samples,528,1,19,modified,17,2,IoTCoreDefaultApp/IoTCoreDefaultApp/Utils/Common.cs,high,0
samples,528,1,2,modified,2,0,IoTCoreDefaultApp/IoTCoreDefaultApp/Utils/Constants.cs,high,0
samples,528,1,34,modified,33,1,IoTCoreDefaultApp/IoTCoreDefaultApp/Utils/CortanaHelper.cs,high,0
samples,528,1,69,added,69,0,IoTCoreDefaultApp/IoTCoreDefaultApp/Utils/ImageLanguages.cs,high,0
samples,528,1,49,modified,45,4,IoTCoreDefaultApp/IoTCoreDefaultApp/Views/OOBEWelcome.xaml,medium,0
samples,528,1,162,modified,156,6,IoTCoreDefaultApp/IoTCoreDefaultApp/Views/OOBEWelcome.xaml.cs,high,0
samples,528,1,53,modified,46,7,IoTCoreDefaultApp/IoTCoreDefaultApp/Views/Settings.xaml,medium,0
samples,528,1,279,modified,238,41,IoTCoreDefaultApp/IoTCoreDefaultApp/Views/Settings.xaml.cs,high,0
samples,528,1,4,modified,2,2,IoTCoreDefaultApp/IoTCoreDefaultApp/Views/WebBrowserPage.xaml.cs,high,0
samples,527,11,7,modified,7,0,IoTCoreDefaultApp/IoTCoreDefaultApp/IoTCoreDefaultApp.csproj,low,0
samples,527,11,244,modified,165,79,IoTCoreDefaultApp/IoTCoreDefaultApp/Presenters/NetworkPresenter.cs,high,0
samples,527,11,162,added,162,0,IoTCoreDefaultApp/IoTCoreDefaultApp/UserControls/NetworkListControl.xaml,medium,0
samples,527,11,281,added,281,0,IoTCoreDefaultApp/IoTCoreDefaultApp/UserControls/NetworkListControl.xaml.cs,high,0
samples,527,11,121,modified,5,116,IoTCoreDefaultApp/IoTCoreDefaultApp/Views/OOBENetwork.xaml,medium,0
samples,527,11,199,modified,10,189,IoTCoreDefaultApp/IoTCoreDefaultApp/Views/OOBENetwork.xaml.cs,high,0
samples,527,11,17,modified,13,4,IoTCoreDefaultApp/IoTCoreDefaultApp/Views/Screensaver.xaml.cs,high,0
samples,527,11,155,modified,2,153,IoTCoreDefaultApp/IoTCoreDefaultApp/Views/Settings.xaml,medium,0
samples,527,11,278,modified,29,249,IoTCoreDefaultApp/IoTCoreDefaultApp/Views/Settings.xaml.cs,high,0
samples,526,1,18,modified,18,0,DriverSamples/gpiokmdfdemo/gpiokmdfdemo/gpiokmdfdemo.cpp,high,0
samples,525,2,76,modified,51,25,IoTCoreDefaultApp/IoTCoreDefaultApp/Presenters/ConnectedDevicePresenter.cs,high,0
samples,524,2,11,modified,4,7,IoTCoreDefaultApp/IoTCoreDefaultApp/Presenters/ConnectedDevicePresenter.cs,high,1
samples,524,2,2,modified,1,1,IoTCoreDefaultApp/IoTCoreDefaultApp/UserControls/TopBarUC.xaml.cs,high,1
samples,524,2,6,modified,3,3,IoTCoreDefaultApp/IoTCoreDefaultApp/Views/CommandLinePage.xaml.cs,high,1
samples,524,2,22,modified,3,19,IoTCoreDefaultApp/IoTCoreDefaultApp/Views/MainPage.xaml.cs,high,1
samples,524,2,18,modified,8,10,IoTCoreDefaultApp/IoTCoreDefaultApp/Views/OOBENetwork.xaml.cs,high,1
samples,524,2,6,modified,3,3,IoTCoreDefaultApp/IoTCoreDefaultApp/Views/OOBEWelcome.xaml.cs,high,1
samples,524,2,2,modified,1,1,IoTCoreDefaultApp/IoTCoreDefaultApp/Views/Screensaver.xaml.cs,high,1
samples,524,2,60,modified,30,30,IoTCoreDefaultApp/IoTCoreDefaultApp/Views/Settings.xaml.cs,high,1
samples,524,2,7,modified,3,4,IoTCoreDefaultApp/IoTCoreDefaultApp/Views/TutorialContentPage.xaml.cs,high,1
samples,524,2,2,modified,1,1,IoTCoreDefaultApp/IoTCoreDefaultApp/Views/TutorialHelloBlinkyPage.xaml.cs,high,1
samples,520,4,28,added,28,0,WindowsUpdateStatus/App.xaml,medium,1
samples,520,4,102,added,102,0,WindowsUpdateStatus/App.xaml.cs,high,1
samples,520,4,0,added,0,0,WindowsUpdateStatus/Assets/LockScreenLogo.scale-200.png,low,1
samples,520,4,0,added,0,0,WindowsUpdateStatus/Assets/SplashScreen.scale-200.png,low,1
samples,520,4,0,added,0,0,WindowsUpdateStatus/Assets/Square150x150Logo.scale-200.png,low,1
samples,520,4,0,added,0,0,WindowsUpdateStatus/Assets/Square44x44Logo.scale-200.png,low,1
samples,520,4,0,added,0,0,WindowsUpdateStatus/Assets/Square44x44Logo.targetsize-24_altform-unplated.png,low,1
samples,520,4,0,added,0,0,WindowsUpdateStatus/Assets/StoreLogo.png,low,1
samples,520,4,0,added,0,0,WindowsUpdateStatus/Assets/Wide310x150Logo.scale-200.png,low,1
samples,520,4,21,added,21,0,WindowsUpdateStatus/LICENSE.txt,low,1
samples,520,4,77,added,77,0,WindowsUpdateStatus/MainPage.xaml,medium,1
samples,520,4,118,added,118,0,WindowsUpdateStatus/MainPage.xaml.cs,high,1
samples,520,4,51,added,51,0,WindowsUpdateStatus/Package.appxmanifest,medium,1
samples,520,4,29,added,29,0,WindowsUpdateStatus/Properties/AssemblyInfo.cs,high,1
samples,520,4,31,added,31,0,WindowsUpdateStatus/Properties/Default.rd.xml,medium,1
samples,520,4,17,added,17,0,WindowsUpdateStatus/README.md,low,1
samples,520,4,151,added,151,0,WindowsUpdateStatus/WindowsUpdateStatus.csproj,low,1
samples,520,4,43,added,43,0,WindowsUpdateStatus/WindowsUpdateStatus.sln,low,1
samples,519,1,8,modified,4,4,IoTCoreDefaultApp/IoTCoreDefaultApp/Views/WebBrowserPage.xaml,medium,0
samples,519,1,3,modified,1,2,IoTCoreDefaultApp/IoTCoreDefaultApp/Views/WebBrowserPage.xaml.cs,high,0
samples,518,1,77,modified,33,44,IoTCoreDefaultApp/IoTCoreDefaultApp/Strings/de-DE/Resources.resw,NaN,0
samples,518,1,77,modified,33,44,IoTCoreDefaultApp/IoTCoreDefaultApp/Strings/es-ES/Resources.resw,NaN,0
samples,518,1,77,modified,33,44,IoTCoreDefaultApp/IoTCoreDefaultApp/Strings/fr-FR/Resources.resw,NaN,0
samples,518,1,77,modified,33,44,IoTCoreDefaultApp/IoTCoreDefaultApp/Strings/it-IT/Resources.resw,NaN,0
samples,518,1,52,modified,4,48,IoTCoreDefaultApp/IoTCoreDefaultApp/Strings/ja-JP/Resources.resw,NaN,0
samples,518,1,82,modified,37,45,IoTCoreDefaultApp/IoTCoreDefaultApp/Strings/ko-KR/Resources.resw,NaN,0
samples,518,1,49,modified,1,48,IoTCoreDefaultApp/IoTCoreDefaultApp/Strings/pt-BR/Resources.resw,NaN,0
samples,518,1,54,modified,5,49,IoTCoreDefaultApp/IoTCoreDefaultApp/Strings/ru-RU/Resources.resw,NaN,0
samples,518,1,49,modified,1,48,IoTCoreDefaultApp/IoTCoreDefaultApp/Strings/zh-CN/Resources.resw,NaN,0
samples,518,1,49,modified,1,48,IoTCoreDefaultApp/IoTCoreDefaultApp/Strings/zh-TW/Resources.resw,NaN,0
samples,517,0,3,removed,0,3,DeviceIOController/.gitignore,low,1
samples,517,0,9,removed,0,9,DeviceIOController/App.xaml,medium,1
samples,517,0,122,removed,0,122,DeviceIOController/App.xaml.cpp,high,1
samples,517,0,29,removed,0,29,DeviceIOController/App.xaml.h,high,1
samples,517,0,0,removed,0,0,DeviceIOController/Assets/LockScreenLogo.scale-200.png,low,1
samples,517,0,0,removed,0,0,DeviceIOController/Assets/SplashScreen.scale-200.png,low,1
samples,517,0,0,removed,0,0,DeviceIOController/Assets/Square150x150Logo.scale-200.png,low,1
samples,517,0,0,removed,0,0,DeviceIOController/Assets/Square44x44Logo.scale-200.png,low,1
samples,517,0,0,removed,0,0,DeviceIOController/Assets/Square44x44Logo.targetsize-24_altform-unplated.png,low,1
samples,517,0,0,removed,0,0,DeviceIOController/Assets/StoreLogo.png,low,1
samples,517,0,0,removed,0,0,DeviceIOController/Assets/Wide310x150Logo.scale-200.png,low,1
samples,517,0,40,removed,0,40,DeviceIOController/DeviceIoControlUwp.sln,low,1
samples,517,0,197,removed,0,197,DeviceIOController/DeviceIoControlUwp.vcxproj,medium,1
samples,517,0,57,removed,0,57,DeviceIOController/DeviceIoControlUwp.vcxproj.filters,medium,1
samples,517,0,0,removed,0,0,DeviceIOController/DeviceIoControlUwp_TemporaryKey.pfx,low,1
samples,517,0,21,removed,0,21,DeviceIOController/LICENSE.txt,low,1
samples,517,0,14,removed,0,14,DeviceIOController/MainPage.xaml,medium,1
FootballData,34,2,480,modified,240,240,Germany/Bundesliga/1965/matches.csv,low,0
FootballData,34,2,546,modified,306,240,Germany/Bundesliga/1966/matches.csv,low,0
FootballData,34,2,546,modified,306,240,Germany/Bundesliga/1967/matches.csv,low,0
FootballData,34,2,546,modified,306,240,Germany/Bundesliga/1968/matches.csv,low,0
FootballData,34,2,546,modified,306,240,Germany/Bundesliga/1969/matches.csv,low,0
FootballData,34,2,546,modified,306,240,Germany/Bundesliga/1970/matches.csv,low,0
FootballData,34,2,546,modified,306,240,Germany/Bundesliga/1971/matches.csv,low,0
FootballData,34,2,241,removed,0,241,Germany/Bundesliga/1972/matches.csv,low,0
FootballData,34,2,241,removed,0,241,Germany/Bundesliga/1973/matches.csv,low,0
FootballData,34,2,241,removed,0,241,Germany/Bundesliga/1974/matches.csv,low,0
FootballData,34,2,241,removed,0,241,Germany/Bundesliga/1975/matches.csv,low,0
FootballData,34,2,241,removed,0,241,Germany/Bundesliga/1976/matches.csv,low,0
FootballData,34,2,241,removed,0,241,Germany/Bundesliga/1977/matches.csv,low,0
FootballData,34,2,241,removed,0,241,Germany/Bundesliga/1978/matches.csv,low,0
FootballData,34,2,241,removed,0,241,Germany/Bundesliga/1979/matches.csv,low,0
FootballData,34,2,241,removed,0,241,Germany/Bundesliga/1980/matches.csv,low,0
FootballData,34,2,241,removed,0,241,Germany/Bundesliga/1981/matches.csv,low,0
FootballData,34,2,241,removed,0,241,Germany/Bundesliga/1982/matches.csv,low,0
FootballData,34,2,241,removed,0,241,Germany/Bundesliga/1983/matches.csv,low,0
FootballData,34,2,241,removed,0,241,Germany/Bundesliga/1984/matches.csv,low,0
FootballData,34,2,545,modified,305,240,Germany/Bundesliga/1985/matches.csv,low,0
FootballData,34,2,241,removed,0,241,Germany/Bundesliga/1986/matches.csv,low,0
FootballData,34,2,241,removed,0,241,Germany/Bundesliga/1987/matches.csv,low,0
FootballData,34,2,546,modified,306,240,Germany/Bundesliga/1988/matches.csv,low,0
FootballData,34,2,241,removed,0,241,Germany/Bundesliga/1989/matches.csv,low,0
FootballData,34,2,241,removed,0,241,Germany/Bundesliga/1990/matches.csv,low,0
FootballData,34,2,241,removed,0,241,Germany/Bundesliga/1991/matches.csv,low,0
FootballData,34,2,241,removed,0,241,Germany/Bundesliga/1992/matches.csv,low,0
FootballData,34,2,241,removed,0,241,Germany/Bundesliga/1993/matches.csv,low,0
FootballData,34,2,241,removed,0,241,Germany/Bundesliga/1994/matches.csv,low,0
FootballData,33,2,2,modified,2,0,README.md,low,0
FootballData,32,1,241,added,241,0,Germany/Bundesliga/1964/matches.csv,low,0
FootballData,32,1,241,added,241,0,Germany/Bundesliga/1965/matches.csv,low,0
FootballData,32,1,241,added,241,0,Germany/Bundesliga/1966/matches.csv,low,0
FootballData,32,1,241,added,241,0,Germany/Bundesliga/1967/matches.csv,low,0
FootballData,32,1,241,added,241,0,Germany/Bundesliga/1968/matches.csv,low,0
FootballData,32,1,241,added,241,0,Germany/Bundesliga/1969/matches.csv,low,0
FootballData,32,1,241,added,241,0,Germany/Bundesliga/1970/matches.csv,low,0
FootballData,32,1,241,added,241,0,Germany/Bundesliga/1971/matches.csv,low,0
FootballData,32,1,241,added,241,0,Germany/Bundesliga/1972/matches.csv,low,0
FootballData,32,1,241,added,241,0,Germany/Bundesliga/1973/matches.csv,low,0
FootballData,32,1,241,added,241,0,Germany/Bundesliga/1974/matches.csv,low,0
FootballData,32,1,241,added,241,0,Germany/Bundesliga/1975/matches.csv,low,0
FootballData,32,1,241,added,241,0,Germany/Bundesliga/1976/matches.csv,low,0
FootballData,32,1,241,added,241,0,Germany/Bundesliga/1977/matches.csv,low,0
FootballData,32,1,241,added,241,0,Germany/Bundesliga/1978/matches.csv,low,0
FootballData,32,1,241,added,241,0,Germany/Bundesliga/1979/matches.csv,low,0
FootballData,32,1,241,added,241,0,Germany/Bundesliga/1980/matches.csv,low,0
FootballData,32,1,241,added,241,0,Germany/Bundesliga/1981/matches.csv,low,0
FootballData,32,1,241,added,241,0,Germany/Bundesliga/1982/matches.csv,low,0
FootballData,32,1,241,added,241,0,Germany/Bundesliga/1983/matches.csv,low,0
FootballData,32,1,241,added,241,0,Germany/Bundesliga/1984/matches.csv,low,0
FootballData,32,1,241,added,241,0,Germany/Bundesliga/1985/matches.csv,low,0
FootballData,32,1,241,added,241,0,Germany/Bundesliga/1986/matches.csv,low,0
FootballData,32,1,241,added,241,0,Germany/Bundesliga/1987/matches.csv,low,0
FootballData,32,1,241,added,241,0,Germany/Bundesliga/1988/matches.csv,low,0
FootballData,32,1,241,added,241,0,Germany/Bundesliga/1989/matches.csv,low,0
FootballData,32,1,241,added,241,0,Germany/Bundesliga/1990/matches.csv,low,0
FootballData,32,1,241,added,241,0,Germany/Bundesliga/1991/matches.csv,low,0
FootballData,32,1,241,added,241,0,Germany/Bundesliga/1992/matches.csv,low,0
FootballData,32,1,241,added,241,0,Germany/Bundesliga/1993/matches.csv,low,0
FootballData,31,1,0,renamed,0,0,MLS/1996/Teams/CLB.csv,low,0
FootballData,31,1,0,renamed,0,0,MLS/1996/Teams/COL.csv,low,0
FootballData,31,1,0,renamed,0,0,MLS/1996/Teams/DAL.csv,low,0
FootballData,31,1,0,renamed,0,0,MLS/1996/Teams/DC.csv,low,0
FootballData,31,1,0,renamed,0,0,MLS/1996/Teams/LA.csv,low,0
FootballData,31,1,0,renamed,0,0,MLS/1996/Teams/NE.csv,low,0
FootballData,31,1,0,renamed,0,0,MLS/1996/Teams/RBNY.csv,low,0
FootballData,31,1,0,renamed,0,0,MLS/1996/Teams/SJ.csv,low,0
FootballData,31,1,0,renamed,0,0,MLS/1996/Teams/SKC.csv,low,0
FootballData,31,1,0,renamed,0,0,MLS/1996/Teams/TBM.csv,low,0
FootballData,31,1,0,renamed,0,0,MLS/1997/Teams/CLB.csv,low,0
FootballData,31,1,0,renamed,0,0,MLS/1997/Teams/COL.csv,low,0
FootballData,31,1,0,renamed,0,0,MLS/1997/Teams/DAL.csv,low,0
FootballData,31,1,0,renamed,0,0,MLS/1997/Teams/DC.csv,low,0
FootballData,31,1,0,renamed,0,0,MLS/1997/Teams/LA.csv,low,0
FootballData,31,1,0,renamed,0,0,MLS/1997/Teams/NE.csv,low,0
FootballData,31,1,0,renamed,0,0,MLS/1997/Teams/RBNY.csv,low,0
FootballData,31,1,0,renamed,0,0,MLS/1997/Teams/SJ.csv,low,0
FootballData,31,1,0,renamed,0,0,MLS/1997/Teams/SKC.csv,low,0
FootballData,31,1,0,renamed,0,0,MLS/1997/Teams/TBM.csv,low,0
FootballData,31,1,219,added,219,0,MLS/1997/assists.csv,low,0
FootballData,31,1,219,added,219,0,MLS/1997/fouls.csv,low,0
FootballData,31,1,28,added,28,0,MLS/1997/goalkeeping.csv,low,0
FootballData,31,1,28,added,28,0,MLS/1997/saves.csv,low,0
FootballData,31,1,219,added,219,0,MLS/1997/shots.csv,low,0
FootballData,31,1,28,added,28,0,MLS/1997/shutouts.csv,low,0
FootballData,31,1,0,renamed,0,0,MLS/1998/Teams/CHI.csv,low,0
FootballData,31,1,0,renamed,0,0,MLS/1998/Teams/CLB.csv,low,0
FootballData,31,1,0,renamed,0,0,MLS/1998/Teams/COL.csv,low,0
FootballData,31,1,0,renamed,0,0,MLS/1998/Teams/DAL.csv,low,0
FootballData,30,1,33,added,33,0,MLS/1996/CLB.csv,low,0
FootballData,30,1,33,added,33,0,MLS/1996/COL.csv,low,0
FootballData,30,1,33,added,33,0,MLS/1996/DAL.csv,low,0
FootballData,30,1,33,added,33,0,MLS/1996/DC.csv,low,0
FootballData,30,1,33,added,33,0,MLS/1996/LA.csv,low,0
FootballData,30,1,33,added,33,0,MLS/1996/NE.csv,low,0
FootballData,30,1,33,added,33,0,MLS/1996/RBNY.csv,low,0
FootballData,30,1,33,added,33,0,MLS/1996/SJ.csv,low,0
FootballData,30,1,33,added,33,0,MLS/1996/SKC.csv,low,0
FootballData,30,1,33,added,33,0,MLS/1996/TBM.csv,low,0
FootballData,30,1,33,added,33,0,MLS/1997/CLB.csv,low,0
FootballData,30,1,33,added,33,0,MLS/1997/COL.csv,low,0
FootballData,30,1,33,added,33,0,MLS/1997/DAL.csv,low,0
FootballData,30,1,33,added,33,0,MLS/1997/DC.csv,low,0
FootballData,30,1,33,added,33,0,MLS/1997/LA.csv,low,0
FootballData,30,1,33,added,33,0,MLS/1997/NE.csv,low,0
FootballData,30,1,33,added,33,0,MLS/1997/RBNY.csv,low,0
FootballData,30,1,33,added,33,0,MLS/1997/SJ.csv,low,0
FootballData,30,1,33,added,33,0,MLS/1997/SKC.csv,low,0
FootballData,30,1,33,added,33,0,MLS/1997/TBM.csv,low,0
FootballData,30,1,33,added,33,0,MLS/1998/CHI.csv,low,0
FootballData,30,1,33,added,33,0,MLS/1998/CLB.csv,low,0
FootballData,30,1,33,added,33,0,MLS/1998/COL.csv,low,0
FootballData,30,1,33,added,33,0,MLS/1998/DAL.csv,low,0
FootballData,30,1,33,added,33,0,MLS/1998/DC.csv,low,0
FootballData,30,1,33,added,33,0,MLS/1998/LA.csv,low,0
FootballData,30,1,33,added,33,0,MLS/1998/MIA.csv,low,0
FootballData,30,1,33,added,33,0,MLS/1998/NE.csv,low,0
FootballData,30,1,33,added,33,0,MLS/1998/RBNY.csv,low,0
FootballData,30,1,33,added,33,0,MLS/1998/SJ.csv,low,0
FootballData,29,18,7,added,7,0,World Cups/world-cup-1950/final_matches.csv,low,0
FootballData,29,18,5,added,5,0,World Cups/world-cup-1950/final_round_groups.csv,low,0
FootballData,29,18,4,added,4,0,World Cups/world-cup-1950/first_round_groups.csv,low,0
FootballData,29,18,17,added,17,0,World Cups/world-cup-1950/group_matches.csv,low,0
FootballData,29,18,30,added,30,0,World Cups/world-cup-1950/squads/bo-bolivia.txt,low,0
FootballData,29,18,30,added,30,0,World Cups/world-cup-1950/squads/br-brazil.txt,low,0
FootballData,29,18,30,added,30,0,World Cups/world-cup-1950/squads/ch-switzerland.txt,low,0
FootballData,29,18,30,added,30,0,World Cups/world-cup-1950/squads/cl-chile.txt,low,0
FootballData,29,18,29,added,29,0,World Cups/world-cup-1950/squads/en-england.txt,low,0
FootballData,29,18,30,added,30,0,World Cups/world-cup-1950/squads/es-espana.txt,low,0
FootballData,29,18,30,added,30,0,World Cups/world-cup-1950/squads/it-italy.txt,low,0
FootballData,29,18,30,added,30,0,World Cups/world-cup-1950/squads/mx-mexico.txt,low,0
FootballData,29,18,30,added,30,0,World Cups/world-cup-1950/squads/py-paraguay.txt,low,0
FootballData,29,18,30,added,30,0,World Cups/world-cup-1950/squads/se-sweden.txt,low,0
FootballData,29,18,27,added,27,0,World Cups/world-cup-1950/squads/us-united-states.txt,low,0
FootballData,29,18,30,added,30,0,World Cups/world-cup-1950/squads/uy-uruguay.txt,low,0
FootballData,29,18,30,added,30,0,World Cups/world-cup-1950/squads/yug-yugoslavia.txt,low,0
FootballData,29,18,9,added,9,0,World Cups/world-cup-1954/final_matches.csv,low,0
FootballData,29,18,5,added,5,0,World Cups/world-cup-1954/first_round_groups.csv,low,0
FootballData,29,18,19,added,19,0,World Cups/world-cup-1954/group_matches.csv,low,0
FootballData,29,18,30,added,30,0,World Cups/world-cup-1954/squads/at-austria.txt,low,0
FootballData,29,18,30,added,30,0,World Cups/world-cup-1954/squads/be-belgium.txt,low,0
FootballData,29,18,30,added,30,0,World Cups/world-cup-1954/squads/br-brazil.txt,low,0
FootballData,29,18,30,added,30,0,World Cups/world-cup-1954/squads/ch-switzerland.txt,low,0
FootballData,29,18,30,added,30,0,World Cups/world-cup-1954/squads/en-england.txt,low,0
FootballData,29,18,30,added,30,0,World Cups/world-cup-1954/squads/fr-france.txt,low,0
FootballData,29,18,30,added,30,0,World Cups/world-cup-1954/squads/frg-west-germany.txt,low,0
FootballData,29,18,30,added,30,0,World Cups/world-cup-1954/squads/hu-hungary.txt,low,0
FootballData,29,18,30,added,30,0,World Cups/world-cup-1954/squads/it-italy.txt,low,0
FootballData,29,18,28,added,28,0,World Cups/world-cup-1954/squads/kr-south-korea.txt,low,0
FootballData,28,6,30,added,30,0,World Cups/world-cup-1950/cup.yml,medium,1
FootballData,28,6,7,added,7,0,World Cups/world-cup-1950/final_matches.csv,low,1
FootballData,28,6,5,added,5,0,World Cups/world-cup-1950/final_round_groups.csv,low,1
FootballData,28,6,4,added,4,0,World Cups/world-cup-1950/first_round_groups.csv,low,1
FootballData,28,6,17,added,17,0,World Cups/world-cup-1950/group_matches.csv,low,1
FootballData,28,6,30,added,30,0,World Cups/world-cup-1950/squads/bo-bolivia.txt,low,1
FootballData,28,6,30,added,30,0,World Cups/world-cup-1950/squads/br-brazil.txt,low,1
FootballData,28,6,30,added,30,0,World Cups/world-cup-1950/squads/ch-switzerland.txt,low,1
FootballData,28,6,30,added,30,0,World Cups/world-cup-1950/squads/cl-chile.txt,low,1
FootballData,28,6,29,added,29,0,World Cups/world-cup-1950/squads/en-england.txt,low,1
FootballData,28,6,30,added,30,0,World Cups/world-cup-1950/squads/es-espana.txt,low,1
FootballData,28,6,30,added,30,0,World Cups/world-cup-1950/squads/it-italy.txt,low,1
FootballData,28,6,30,added,30,0,World Cups/world-cup-1950/squads/mx-mexico.txt,low,1
FootballData,28,6,30,added,30,0,World Cups/world-cup-1950/squads/py-paraguay.txt,low,1
FootballData,28,6,30,added,30,0,World Cups/world-cup-1950/squads/se-sweden.txt,low,1
FootballData,28,6,27,added,27,0,World Cups/world-cup-1950/squads/us-united-states.txt,low,1
FootballData,28,6,30,added,30,0,World Cups/world-cup-1950/squads/uy-uruguay.txt,low,1
FootballData,28,6,30,added,30,0,World Cups/world-cup-1950/squads/yug-yugoslavia.txt,low,1
FootballData,28,6,9,added,9,0,World Cups/world-cup-1954/final_matches.csv,low,1
FootballData,28,6,5,added,5,0,World Cups/world-cup-1954/first_round_groups.csv,low,1
FootballData,28,6,19,added,19,0,World Cups/world-cup-1954/group_matches.csv,low,1
FootballData,28,6,30,added,30,0,World Cups/world-cup-1954/squads/at-austria.txt,low,1
FootballData,28,6,30,added,30,0,World Cups/world-cup-1954/squads/be-belgium.txt,low,1
FootballData,28,6,30,added,30,0,World Cups/world-cup-1954/squads/br-brazil.txt,low,1
FootballData,28,6,30,added,30,0,World Cups/world-cup-1954/squads/ch-switzerland.txt,low,1
FootballData,28,6,30,added,30,0,World Cups/world-cup-1954/squads/en-england.txt,low,1
FootballData,28,6,30,added,30,0,World Cups/world-cup-1954/squads/fr-france.txt,low,1
FootballData,28,6,30,added,30,0,World Cups/world-cup-1954/squads/frg-west-germany.txt,low,1
FootballData,28,6,30,added,30,0,World Cups/world-cup-1954/squads/hu-hungary.txt,low,1
FootballData,28,6,30,added,30,0,World Cups/world-cup-1954/squads/it-italy.txt,low,1
FootballData,27,5,1,modified,1,0,.gitignore,low,0
FootballData,27,5,0,added,0,0,UEFA_European_Championship/.DS_Store,NaN,0
FootballData,27,5,0,renamed,0,0,UEFA_European_Championship/Euro 2012/Euro 2012 stats PLAYERS.csv,low,0
FootballData,27,5,0,renamed,0,0,UEFA_European_Championship/Euro 2012/Euro 2012 stats TEAM.csv,low,0
FootballData,27,5,0,renamed,0,0,UEFA_European_Championship/Euro 2012/Euro 2012 stats- PLAYERS EXTRA DATA.csv,low,0
FootballData,27,5,5,added,5,0,UEFA_European_Championship/Euro 2012/groups.csv,low,0
FootballData,27,5,32,added,32,0,UEFA_European_Championship/Euro 2012/matches.csv,low,0
FootballData,27,5,5,added,5,0,UEFA_European_Championship/Euro 2016/groups.csv,low,0
FootballData,27,5,52,added,52,0,UEFA_European_Championship/Euro 2016/matches.csv,low,0
FootballData,27,5,0,renamed,0,0,UEFA_European_Championship/Euro 2016/players_json/albania-players.json,medium,0
FootballData,27,5,0,renamed,0,0,UEFA_European_Championship/Euro 2016/players_json/austria-players.json,medium,0
FootballData,27,5,0,renamed,0,0,UEFA_European_Championship/Euro 2016/players_json/belgium-players.json,medium,0
FootballData,27,5,0,renamed,0,0,UEFA_European_Championship/Euro 2016/players_json/croatia-players.json,medium,0
FootballData,27,5,0,renamed,0,0,UEFA_European_Championship/Euro 2016/players_json/czech-players.json,medium,0
FootballData,27,5,0,renamed,0,0,UEFA_European_Championship/Euro 2016/players_json/england-players.json,medium,0
FootballData,27,5,0,renamed,0,0,UEFA_European_Championship/Euro 2016/players_json/france-players.json,medium,0
FootballData,27,5,0,renamed,0,0,UEFA_European_Championship/Euro 2016/players_json/german-players.json,medium,0
FootballData,27,5,0,renamed,0,0,UEFA_European_Championship/Euro 2016/players_json/hungary-players.json,medium,0
FootballData,27,5,0,renamed,0,0,UEFA_European_Championship/Euro 2016/players_json/iceland-players.json,medium,0
FootballData,27,5,0,renamed,0,0,UEFA_European_Championship/Euro 2016/players_json/ireland-players.json,medium,0
FootballData,27,5,0,renamed,0,0,UEFA_European_Championship/Euro 2016/players_json/italy-players.json,medium,0
FootballData,27,5,0,renamed,0,0,UEFA_European_Championship/Euro 2016/players_json/northern-ireland-players.json,medium,0
FootballData,27,5,0,renamed,0,0,UEFA_European_Championship/Euro 2016/players_json/poland-players.json,medium,0
FootballData,27,5,0,renamed,0,0,UEFA_European_Championship/Euro 2016/players_json/portugal-players.json,medium,0
FootballData,27,5,0,renamed,0,0,UEFA_European_Championship/Euro 2016/players_json/romania-players.json,medium,0
FootballData,27,5,0,renamed,0,0,UEFA_European_Championship/Euro 2016/players_json/russia-players.json,medium,0
FootballData,27,5,0,renamed,0,0,UEFA_European_Championship/Euro 2016/players_json/slovakia-players.json,medium,0
FootballData,27,5,0,renamed,0,0,UEFA_European_Championship/Euro 2016/players_json/spain-players.json,medium,0
FootballData,27,5,0,renamed,0,0,UEFA_European_Championship/Euro 2016/players_json/sweden-players.json,medium,0
FootballData,27,5,0,renamed,0,0,UEFA_European_Championship/Euro 2016/players_json/swiss-players.json,medium,0
FootballData,26,1,3538,added,3538,0,Turkey/SuperLig/2015-2016/superlig.json,medium,0
FootballData,25,1,46,added,46,0,Turkey/SuperLig/2016-2017/readme.md,low,0
FootballData,24,1,3538,added,3538,0,Turkey/SuperLig/2016-2017/superlig.json,medium,0
FootballData,22,0,242,added,242,0,EPL 1992 - 2015/tables/epl-15-16.json,medium,1
FootballData,21,1,524,modified,262,262,EPL 1992 - 2015/tables/epl-00-01.json,medium,0
FootballData,21,1,524,modified,262,262,EPL 1992 - 2015/tables/epl-01-02.json,medium,0
FootballData,21,1,524,modified,262,262,EPL 1992 - 2015/tables/epl-02-03.json,medium,0
FootballData,21,1,484,modified,242,242,EPL 1992 - 2015/tables/epl-03-04.json,medium,0
FootballData,21,1,484,modified,242,242,EPL 1992 - 2015/tables/epl-04-05.json,medium,0
FootballData,21,1,484,modified,242,242,EPL 1992 - 2015/tables/epl-05-06.json,medium,0
FootballData,21,1,484,modified,242,242,EPL 1992 - 2015/tables/epl-06-07.json,medium,0
FootballData,21,1,484,modified,242,242,EPL 1992 - 2015/tables/epl-07-08.json,medium,0
FootballData,21,1,524,modified,262,262,EPL 1992 - 2015/tables/epl-08-09.json,medium,0
FootballData,21,1,524,modified,262,262,EPL 1992 - 2015/tables/epl-09-10.json,medium,0
FootballData,21,1,484,modified,242,242,EPL 1992 - 2015/tables/epl-10-11.json,medium,0
FootballData,21,1,484,modified,242,242,EPL 1992 - 2015/tables/epl-11-12.json,medium,0
FootballData,21,1,484,modified,242,242,EPL 1992 - 2015/tables/epl-12-13.json,medium,0
FootballData,21,1,484,modified,242,242,EPL 1992 - 2015/tables/epl-13-14.json,medium,0
FootballData,21,1,484,modified,242,242,EPL 1992 - 2015/tables/epl-14-15.json,medium,0
FootballData,21,1,576,modified,288,288,EPL 1992 - 2015/tables/epl-92-93.json,medium,0
FootballData,21,1,576,modified,288,288,EPL 1992 - 2015/tables/epl-93-94.json,medium,0
FootballData,21,1,576,modified,288,288,EPL 1992 - 2015/tables/epl-94-95.json,medium,0
FootballData,21,1,524,modified,262,262,EPL 1992 - 2015/tables/epl-95-96.json,medium,0
FootballData,21,1,524,modified,262,262,EPL 1992 - 2015/tables/epl-96-97.json,medium,0
FootballData,21,1,524,modified,262,262,EPL 1992 - 2015/tables/epl-97-98.json,medium,0
FootballData,21,1,524,modified,262,262,EPL 1992 - 2015/tables/epl-98-99.json,medium,0
FootballData,21,1,524,modified,262,262,EPL 1992 - 2015/tables/epl-99-00.json,medium,0
FootballData,20,1,8,modified,4,4,EPL 1992 - 2015/tables/epl-00-01.json,medium,0
FootballData,20,1,40,modified,20,20,EPL 1992 - 2015/tables/epl-01-02.json,medium,0
FootballData,20,1,40,modified,20,20,EPL 1992 - 2015/tables/epl-02-03.json,medium,0
FootballData,20,1,14,modified,7,7,EPL 1992 - 2015/tables/epl-03-04.json,medium,0
FootballData,20,1,8,modified,4,4,EPL 1992 - 2015/tables/epl-04-05.json,medium,0
FootballData,20,1,14,modified,7,7,EPL 1992 - 2015/tables/epl-05-06.json,medium,0
FootballData,20,1,22,modified,11,11,EPL 1992 - 2015/tables/epl-06-07.json,medium,0
FootballData,20,1,14,modified,7,7,EPL 1992 - 2015/tables/epl-08-09.json,medium,0
FootballData,20,1,14,modified,7,7,EPL 1992 - 2015/tables/epl-09-10.json,medium,0
FootballData,20,1,8,modified,4,4,EPL 1992 - 2015/tables/epl-10-11.json,medium,0
FootballData,20,1,12,modified,6,6,EPL 1992 - 2015/tables/epl-11-12.json,medium,0
FootballData,20,1,2,modified,1,1,EPL 1992 - 2015/tables/epl-13-14.json,medium,0
FootballData,20,1,44,modified,22,22,EPL 1992 - 2015/tables/epl-92-93.json,medium,0
FootballData,20,1,6,modified,3,3,EPL 1992 - 2015/tables/epl-93-94.json,medium,0
FootballData,20,1,10,modified,5,5,EPL 1992 - 2015/tables/epl-94-95.json,medium,0
FootballData,20,1,8,modified,4,4,EPL 1992 - 2015/tables/epl-95-96.json,medium,0
FootballData,20,1,8,modified,4,4,EPL 1992 - 2015/tables/epl-96-97.json,medium,0
FootballData,20,1,8,modified,4,4,EPL 1992 - 2015/tables/epl-97-98.json,medium,0
FootballData,20,1,8,modified,4,4,EPL 1992 - 2015/tables/epl-98-99.json,medium,0
FootballData,20,1,8,modified,4,4,EPL 1992 - 2015/tables/epl-99-00.json,medium,0
FootballData,15,1,20,added,20,0,Football-results (22 countries)/README.md,low,0
FootballData,15,1,157343,added,157343,0,Football-results (22 countries)/all.csv,low,0
FootballData,15,1,0,added,0,0,Football-results (22 countries)/all.db,low,0
FootballData,15,1,0,added,0,0,Football-results (22 countries)/austria/adeg-erste-liga-2003-2004.xls,NaN,0
FootballData,15,1,0,added,0,0,Football-results (22 countries)/austria/adeg-erste-liga-2004-2005.xls,NaN,0
FootballData,15,1,0,added,0,0,Football-results (22 countries)/austria/adeg-erste-liga-2005-2006.xls,NaN,0
FootballData,15,1,0,added,0,0,Football-results (22 countries)/austria/adeg-erste-liga-2006-2007.xls,NaN,0
FootballData,15,1,0,added,0,0,Football-results (22 countries)/austria/adeg-erste-liga-2007-2008.xls,NaN,0
FootballData,15,1,0,added,0,0,Football-results (22 countries)/austria/erste-liga-1998-1999.xls,NaN,0
FootballData,15,1,0,added,0,0,Football-results (22 countries)/austria/erste-liga-1999-2000.xls,NaN,0
FootballData,15,1,0,added,0,0,Football-results (22 countries)/austria/erste-liga-2000-2001.xls,NaN,0
FootballData,15,1,0,added,0,0,Football-results (22 countries)/austria/erste-liga-2001-2002.xls,NaN,0
FootballData,15,1,0,added,0,0,Football-results (22 countries)/austria/erste-liga-2002-2003.xls,NaN,0
FootballData,15,1,0,added,0,0,Football-results (22 countries)/austria/erste-liga-2008-2009.xls,NaN,0
FootballData,15,1,0,added,0,0,Football-results (22 countries)/austria/erste-liga-2009-2010.xls,NaN,0
FootballData,15,1,0,added,0,0,Football-results (22 countries)/austria/erste-liga-2010-2011.xls,NaN,0
FootballData,15,1,0,added,0,0,Football-results (22 countries)/austria/erste-liga-2011-2012.xls,NaN,0
FootballData,15,1,0,added,0,0,Football-results (22 countries)/austria/erste-liga-2012-2013.xls,NaN,0
FootballData,15,1,0,added,0,0,Football-results (22 countries)/austria/erste-liga-2013-2014.xls,NaN,0
FootballData,15,1,0,added,0,0,Football-results (22 countries)/austria/erste-liga-2014-2015.xls,NaN,0
FootballData,15,1,0,added,0,0,Football-results (22 countries)/austria/erste-liga.xls,NaN,0
FootballData,15,1,0,added,0,0,Football-results (22 countries)/austria/t-mobile-bundesliga-1998-1999.xls,NaN,0
FootballData,15,1,0,added,0,0,Football-results (22 countries)/austria/t-mobile-bundesliga-1999-2000.xls,NaN,0
FootballData,15,1,0,added,0,0,Football-results (22 countries)/austria/t-mobile-bundesliga-2000-2001.xls,NaN,0
FootballData,15,1,0,added,0,0,Football-results (22 countries)/austria/t-mobile-bundesliga-2001-2002.xls,NaN,0
FootballData,15,1,0,added,0,0,Football-results (22 countries)/austria/t-mobile-bundesliga-2002-2003.xls,NaN,0
FootballData,15,1,0,added,0,0,Football-results (22 countries)/austria/t-mobile-bundesliga-2003-2004.xls,NaN,0
FootballData,15,1,0,added,0,0,Football-results (22 countries)/austria/t-mobile-bundesliga-2004-2005.xls,NaN,0
FootballData,15,1,0,added,0,0,Football-results (22 countries)/austria/t-mobile-bundesliga-2005-2006.xls,NaN,0
FootballData,15,1,0,added,0,0,Football-results (22 countries)/austria/t-mobile-bundesliga-2006-2007.xls,NaN,0
FootballData,14,0,2,removed,0,2,.gitignore,low,1
FootballData,14,0,8377,removed,0,8377,EPL 1992 - 2015/2015-results.json,medium,1
FootballData,14,0,155,removed,0,155,EPL 1992 - 2015/2015/2015-08-15.all-epl-games.json,medium,1
FootballData,14,0,238,removed,0,238,EPL 1992 - 2015/2015/2015-08-15.espn.json,medium,1
FootballData,14,0,173,removed,0,173,EPL 1992 - 2015/2015/2015-08-16.all-epl-games.json,medium,1
FootballData,14,0,157,removed,0,157,EPL 1992 - 2015/2015/2015-08-16.espn.json,medium,1
FootballData,14,0,182,removed,0,182,EPL 1992 - 2015/2015/2015-08-17.all-epl-games.json,medium,1
FootballData,14,0,45,removed,0,45,EPL 1992 - 2015/2015/2015-08-17.espn.json,medium,1
FootballData,14,0,182,removed,0,182,EPL 1992 - 2015/2015/2015-08-18.all-epl-games.json,medium,1
FootballData,14,0,94,removed,0,94,EPL 1992 - 2015/2015/2015-08-18.espn.json,medium,1
FootballData,14,0,182,removed,0,182,EPL 1992 - 2015/2015/2015-08-19.all-epl-games.json,medium,1
FootballData,14,0,75,removed,0,75,EPL 1992 - 2015/2015/2015-08-19.espn.json,medium,1
FootballData,14,0,182,removed,0,182,EPL 1992 - 2015/2015/2015-08-20.all-epl-games.json,medium,1
FootballData,14,0,56,removed,0,56,EPL 1992 - 2015/2015/2015-08-20.espn.json,medium,1
FootballData,14,0,182,removed,0,182,EPL 1992 - 2015/2015/2015-08-21.all-epl-games.json,medium,1
FootballData,14,0,73,removed,0,73,EPL 1992 - 2015/2015/2015-08-21.espn.json,medium,1
FootballData,14,0,236,removed,0,236,EPL 1992 - 2015/2015/2015-08-22.all-epl-games.json,medium,1
FootballData,14,0,251,removed,0,251,EPL 1992 - 2015/2015/2015-08-22.espn.json,medium,1
FootballData,14,0,263,removed,0,263,EPL 1992 - 2015/2015/2015-08-23.all-epl-games.json,medium,1
FootballData,14,0,201,removed,0,201,EPL 1992 - 2015/2015/2015-08-23.espn.json,medium,1
FootballData,14,0,272,removed,0,272,EPL 1992 - 2015/2015/2015-08-24.all-epl-games.json,medium,1
FootballData,14,0,42,removed,0,42,EPL 1992 - 2015/2015/2015-08-24.espn.json,medium,1
FootballData,14,0,272,removed,0,272,EPL 1992 - 2015/2015/2015-08-25.all-epl-games.json,medium,1
FootballData,14,0,88,removed,0,88,EPL 1992 - 2015/2015/2015-08-25.espn.json,medium,1
FootballData,14,0,272,removed,0,272,EPL 1992 - 2015/2015/2015-08-26.all-epl-games.json,medium,1
FootballData,14,0,92,removed,0,92,EPL 1992 - 2015/2015/2015-08-26.espn.json,medium,1
FootballData,14,0,272,removed,0,272,EPL 1992 - 2015/2015/2015-08-27.all-epl-games.json,medium,1
FootballData,14,0,52,removed,0,52,EPL 1992 - 2015/2015/2015-08-27.espn.json,medium,1
FootballData,14,0,272,removed,0,272,EPL 1992 - 2015/2015/2015-08-28.all-epl-games.json,medium,1
FootballData,14,0,67,removed,0,67,EPL 1992 - 2015/2015/2015-08-28.espn.json,medium,1
FootballData,12,1,284,added,284,0,World Cups/world-cup-1934/world_cup_1934.json,medium,0
FootballData,11,1,578,added,578,0,World Cups/world-cup-1930/world_cup_1930.json,medium,0
FootballData,10,1,183,modified,182,1,World Cups/world_cup_summary.json,medium,0
FootballData,9,1,1,added,1,0,World Cups/world_cup_summary.json,medium,0
FootballData,8,1,553,added,553,0,football-data.co.uk/england/2014-2015/Championship.csv,low,0
FootballData,8,1,553,added,553,0,football-data.co.uk/england/2014-2015/Conference.csv,low,0
FootballData,8,1,553,added,553,0,football-data.co.uk/england/2014-2015/League 1.csv,low,0
FootballData,8,1,553,added,553,0,football-data.co.uk/england/2014-2015/League 2.csv,low,0
FootballData,8,1,381,added,381,0,football-data.co.uk/england/2014-2015/Premier.csv,low,0
FootballData,7,2,1,added,1,0,footballStats/English_Premier_League/English_Premier_League_1992-1993.json,medium,0
FootballData,7,2,1,added,1,0,footballStats/English_Premier_League/English_Premier_League_1993-1994.json,medium,0
FootballData,7,2,1,added,1,0,footballStats/English_Premier_League/English_Premier_League_1994-1995.json,medium,0
FootballData,7,2,1,added,1,0,footballStats/English_Premier_League/English_Premier_League_1995-1996.json,medium,0
FootballData,7,2,1,added,1,0,footballStats/English_Premier_League/English_Premier_League_1996-1997.json,medium,0
FootballData,7,2,80,added,80,0,footballStats/English_Premier_League/README.md,low,0
FootballData,7,2,102,added,102,0,footballStats/README.md,low,0
FootballData,6,1,341,added,341,0,mls-schedule-2015/mls_schedule_2015.csv,low,0
FootballData,5,2,681,added,681,0,mls_players_2015-01-12.csv,low,0
FootballData,5,2,48,added,48,0,scrape_mls_players.R,NaN,0
FootballData,4,1,4,modified,2,2,Euro 2012/Euro 2012 stats- PLAYERS EXTRA DATA.csv,low,0
FootballData,3,1,28,modified,14,14,Euro 2012/Euro 2012 stats- PLAYERS EXTRA DATA.csv,low,0
FootballData,2,1,34,modified,17,17,Euro 2012/Euro 2012 stats- PLAYERS EXTRA DATA.csv,low,0
FantasyFootballAnalyticsR,44,1,13,added,13,0,R Scripts/Weekly Projections/Gold Mining/WRExample/README.md,low,0
FantasyFootballAnalyticsR,39,0,16,modified,8,8,Config/Data/analysts.csv,low,1
FantasyFootballAnalyticsR,39,0,30,modified,15,15,R Package/ffanalytics/R/leagueScoring.R,NaN,1
FantasyFootballAnalyticsR,39,0,60,modified,30,30,R Scripts/Functions/League Settings.R,NaN,1
FantasyFootballAnalyticsR,30,1,0,added,0,0,ffanalytics_0.1.6.tar.gz,NaN,1
FantasyFootballAnalyticsR,23,6,8,modified,6,2,R Package/ffanalytics/DESCRIPTION,NaN,0
FantasyFootballAnalyticsR,23,6,8,modified,4,4,R Package/ffanalytics/NAMESPACE,NaN,0
FantasyFootballAnalyticsR,23,6,2,modified,1,1,R Package/ffanalytics/R/dataResult.R,NaN,0
FantasyFootballAnalyticsR,23,6,5,modified,4,1,R Package/ffanalytics/R/ffanalytics.R,NaN,0
FantasyFootballAnalyticsR,23,6,30,modified,24,6,R Package/ffanalytics/R/getProjections.R,NaN,0
FantasyFootballAnalyticsR,23,6,21,modified,0,21,R Package/ffanalytics/R/getUrls.R,NaN,0
FantasyFootballAnalyticsR,23,6,16,modified,8,8,R Package/ffanalytics/R/leagueScoring.R,NaN,1
FantasyFootballAnalyticsR,23,6,15,modified,10,5,R Package/ffanalytics/R/projectPoints.R,NaN,0
FantasyFootballAnalyticsR,23,6,107,modified,89,18,R Package/ffanalytics/R/projectionGadget.R,NaN,0
FantasyFootballAnalyticsR,23,6,25,modified,20,5,R Package/ffanalytics/R/readUrl.R,NaN,0
FantasyFootballAnalyticsR,23,6,28,modified,16,12,R Package/ffanalytics/R/retrieveData.R,NaN,0
FantasyFootballAnalyticsR,23,6,85,modified,75,10,R Package/ffanalytics/R/runScrape.R,NaN,0
FantasyFootballAnalyticsR,23,6,159,modified,114,45,R Package/ffanalytics/R/scoringUI.R,NaN,0
FantasyFootballAnalyticsR,23,6,19,modified,16,3,R Package/ffanalytics/R/scrapeGadget.R,NaN,0
FantasyFootballAnalyticsR,23,6,73,added,73,0,R Package/ffanalytics/R/tierFunction.R,NaN,0
FantasyFootballAnalyticsR,23,6,5,modified,1,4,R Package/ffanalytics/man/analystOptions.Rd,NaN,0
FantasyFootballAnalyticsR,23,6,6,renamed,3,3,R Package/ffanalytics/man/ffa.scoreThreshold.Rd,NaN,0
FantasyFootballAnalyticsR,23,6,6,renamed,3,3,R Package/ffanalytics/man/ffa.tierGroups.Rd,NaN,0
FantasyFootballAnalyticsR,23,6,8,renamed,4,4,R Package/ffanalytics/man/ffa.vorAdjustment.Rd,NaN,0
FantasyFootballAnalyticsR,23,6,8,renamed,4,4,R Package/ffanalytics/man/ffa.vorBaseline.Rd,NaN,0
FantasyFootballAnalyticsR,23,6,42,modified,32,10,R Package/ffanalytics/man/getProjections.Rd,NaN,0
FantasyFootballAnalyticsR,23,6,39,modified,27,12,R Package/ffanalytics/man/runScrape.Rd,NaN,0
FantasyFootballAnalyticsR,23,6,9,modified,5,4,R Scripts/Functions/adjustFieldGoalStats.R,NaN,0
FantasyFootballAnalyticsR,23,6,18,modified,9,9,R Scripts/Functions/nflPlayers.R,NaN,0
FantasyFootballAnalyticsR,23,6,14,modified,7,7,R Scripts/Functions/redistributeValues.R,NaN,0
FantasyFootballAnalyticsR,23,6,132,modified,68,64,R Scripts/Functions/scrapeFunctions.R,NaN,0
FantasyFootballAnalyticsR,22,4,51,added,51,0,RMarkdown/PackageIntro/packageIntro.Rmd,NaN,0
FantasyFootballAnalyticsR,22,4,192,added,192,0,RMarkdown/PackageIntro/packageIntro.html,medium,0
FantasyFootballAnalyticsR,22,4,3,modified,3,0,RMarkdown/SubcriptionAccuracy/subscriptionAccuracy.Rmd,NaN,0
FantasyFootballAnalyticsR,22,4,1,modified,1,0,RMarkdown/SubcriptionAccuracy/subscriptionAccuracy.html,medium,0
FantasyFootballAnalyticsR,21,6,240,added,240,0,Config/Data/allUrls.csv,low,0
FantasyFootballAnalyticsR,21,6,28,added,28,0,Config/Data/analysts.csv,low,1
FantasyFootballAnalyticsR,21,6,2925,added,2925,0,Config/Data/dataColumns.csv,low,0
FantasyFootballAnalyticsR,21,6,18,added,18,0,Config/Data/dataSites.csv,low,0
FantasyFootballAnalyticsR,21,6,0,added,0,0,Config/Data/playerData.RData,NaN,0
FantasyFootballAnalyticsR,21,6,2047,added,2047,0,Config/Data/playerData.csv,low,0
FantasyFootballAnalyticsR,21,6,10,added,10,0,Config/Data/playerPositions.csv,low,0
FantasyFootballAnalyticsR,21,6,22,added,22,0,Config/Data/positionMap.csv,low,0
FantasyFootballAnalyticsR,21,6,29,added,29,0,Config/Data/rowRemove.csv,low,0
FantasyFootballAnalyticsR,21,6,69,removed,0,69,Config/cbsPlayers.R,NaN,0
FantasyFootballAnalyticsR,21,6,57,removed,0,57,Config/fbgPlayers.R,NaN,0
FantasyFootballAnalyticsR,21,6,59,removed,0,59,Config/fftPlayers.R,NaN,0
FantasyFootballAnalyticsR,21,6,60,removed,0,60,Config/foxPlayers.R,NaN,0
FantasyFootballAnalyticsR,21,6,13,modified,8,5,Config/playerData.R,NaN,0
FantasyFootballAnalyticsR,21,6,65,removed,0,65,Config/updateNflPlayers.R,NaN,0
FantasyFootballAnalyticsR,21,6,50,removed,0,50,Config/updateYahooPlayers.R,NaN,0
FantasyFootballAnalyticsR,21,6,6453,added,6453,0,Data/statProjections/AAVdata_2015.csv,low,0
FantasyFootballAnalyticsR,21,6,4478,added,4478,0,Data/statProjections/ADPdata_2015.csv,low,0
FantasyFootballAnalyticsR,21,6,1,added,1,0,Data/statProjections/ECR_2015.csv,low,0
FantasyFootballAnalyticsR,21,6,425,added,425,0,Data/statProjections/dbprojections_2015.csv,low,0
FantasyFootballAnalyticsR,21,6,336,added,336,0,Data/statProjections/dlprojections_2015.csv,low,0
FantasyFootballAnalyticsR,21,6,2049,added,2049,0,Data/statProjections/dstprojections_2015.csv,low,0
FantasyFootballAnalyticsR,21,6,112,added,112,0,Data/statProjections/kprojections_2015.csv,low,0
FantasyFootballAnalyticsR,21,6,330,added,330,0,Data/statProjections/lbprojections_2015.csv,low,0
FantasyFootballAnalyticsR,21,6,186,added,186,0,Data/statProjections/qbprojections_2015.csv,low,0
FantasyFootballAnalyticsR,21,6,404,added,404,0,Data/statProjections/rbprojections_2015.csv,low,0
FantasyFootballAnalyticsR,21,6,271,added,271,0,Data/statProjections/teprojections_2015.csv,low,0
FantasyFootballAnalyticsR,21,6,546,added,546,0,Data/statProjections/wrprojections_2015.csv,low,0
FantasyFootballAnalyticsR,21,6,8,modified,4,4,R Scripts/Functions/Functions.R,NaN,0
FantasyFootballAnalyticsR,21,6,46,added,46,0,R Scripts/Functions/adjustFieldGoalStats.R,NaN,0
FantasyFootballAnalyticsR,20,3,1,modified,1,0,Config/fbgPlayers.R,NaN,0
FantasyFootballAnalyticsR,20,3,4,modified,2,2,Config/fftPlayers.R,NaN,0
FantasyFootballAnalyticsR,20,3,101,added,101,0,Config/playerData.R,NaN,0
FantasyFootballAnalyticsR,20,3,2,modified,1,1,Config/updateNflPlayers.R,NaN,0
FantasyFootballAnalyticsR,20,3,66,modified,33,33,Data/NFLTeams.csv,low,0
FantasyFootballAnalyticsR,20,3,0,added,0,0,Data/playerData.RData,NaN,0
FantasyFootballAnalyticsR,20,3,1784,added,1784,0,Data/playerData.csv,low,0
FantasyFootballAnalyticsR,20,3,0,removed,0,0,Figures/passCompDiffernce.png,low,0
FantasyFootballAnalyticsR,20,3,0,removed,0,0,Figures/passTdDiffernce.png,low,0
FantasyFootballAnalyticsR,20,3,0,removed,0,0,Figures/passYdsDiffernce.png,low,0
FantasyFootballAnalyticsR,20,3,2,modified,1,1,R Scripts/Functions/nflPlayers.R,NaN,0
FantasyFootballAnalyticsR,20,3,59,modified,34,25,R Scripts/Functions/scrapeFunctions.R,NaN,0
FantasyFootballAnalyticsR,20,3,0,removed,0,0,R Scripts/Posts/AAV by Teams and Position/Figures/DST AAV.png,low,0
FantasyFootballAnalyticsR,20,3,0,removed,0,0,R Scripts/Posts/AAV by Teams and Position/Figures/K AAV.png,low,0
FantasyFootballAnalyticsR,20,3,0,removed,0,0,R Scripts/Posts/AAV by Teams and Position/Figures/QB AAV.png,low,0
FantasyFootballAnalyticsR,20,3,0,removed,0,0,R Scripts/Posts/AAV by Teams and Position/Figures/RB AAV.png,low,0
FantasyFootballAnalyticsR,20,3,0,removed,0,0,R Scripts/Posts/AAV by Teams and Position/Figures/TE AAV.png,low,0
FantasyFootballAnalyticsR,20,3,0,removed,0,0,R Scripts/Posts/AAV by Teams and Position/Figures/WR AAV.png,low,0
FantasyFootballAnalyticsR,20,3,0,removed,0,0,R Scripts/Posts/Value Gap analysis/Figures/passCompDiffernce.png,low,0
FantasyFootballAnalyticsR,20,3,0,removed,0,0,R Scripts/Posts/Value Gap analysis/Figures/passTdDiffernce.png,low,0
FantasyFootballAnalyticsR,20,3,0,removed,0,0,R Scripts/Posts/Value Gap analysis/Figures/passYdsDiffernce.png,low,0
FantasyFootballAnalyticsR,19,1,3626,added,3626,0,Data/Historical Salaries/actual.csv,low,0
FantasyFootballAnalyticsR,19,1,386,modified,78,308,R Scripts/Salaries/Salaries.R,NaN,0
FantasyFootballAnalyticsR,17,1,1,added,1,0,jdad73,NaN,1
FantasyFootballAnalyticsR,15,1,8,modified,4,4,R Scripts/Rankings/IDP.R,NaN,0
FantasyFootballAnalyticsR,15,1,10,modified,6,4,R Scripts/Rankings/Kickers.R,NaN,0
FantasyFootballAnalyticsR,14,2,337,added,337,0,R Scripts/Salaries/Salaries.R,NaN,0
FantasyFootballAnalyticsR,14,2,9,modified,8,1,README.md,low,0
FantasyFootballAnalyticsR,14,2,5,added,5,0,main.R,NaN,0
FantasyFootballAnalyticsR,10,1,0,renamed,0,0,R Scripts/Posts/Value Gap analysis/Data/players.csv,low,0
FantasyFootballAnalyticsR,10,1,0,renamed,0,0,R Scripts/Posts/Value Gap analysis/Data/playerteams.csv,low,0
FantasyFootballAnalyticsR,10,1,0,renamed,0,0,R Scripts/Posts/Value Gap analysis/Data/qbprojections.csv,low,0
FantasyFootballAnalyticsR,10,1,0,renamed,0,0,R Scripts/Posts/Value Gap analysis/Data/rbprojections.csv,low,0
FantasyFootballAnalyticsR,10,1,0,renamed,0,0,R Scripts/Posts/Value Gap analysis/Data/teprojections.csv,low,0
FantasyFootballAnalyticsR,10,1,0,renamed,0,0,R Scripts/Posts/Value Gap analysis/Data/wrprojections.csv,low,0
FantasyFootballAnalyticsR,10,1,0,added,0,0,R Scripts/Posts/Value Gap analysis/Figures/passCompDiffernce.png,low,0
FantasyFootballAnalyticsR,10,1,0,added,0,0,R Scripts/Posts/Value Gap analysis/Figures/passTdDiffernce.png,low,0
FantasyFootballAnalyticsR,10,1,0,added,0,0,R Scripts/Posts/Value Gap analysis/Figures/passYdsDiffernce.png,low,0
FantasyFootballAnalyticsR,10,1,18,renamed,9,9,R Scripts/Posts/Value Gap analysis/R Scripts/balanceAnalysis.R,NaN,0
FantasyFootballAnalyticsR,9,7,69,added,69,0,Config/cbsPlayers.R,NaN,0
FantasyFootballAnalyticsR,9,7,56,added,56,0,Config/fbgPlayers.R,NaN,0
FantasyFootballAnalyticsR,9,7,59,added,59,0,Config/fftPlayers.R,NaN,0
FantasyFootballAnalyticsR,9,7,60,added,60,0,Config/foxPlayers.R,NaN,0
FantasyFootballAnalyticsR,9,7,4,added,4,0,Config/mysqlaccess.txt,low,0
FantasyFootballAnalyticsR,9,7,4,added,4,0,Config/mysqlaccess_local.txt,low,0
FantasyFootballAnalyticsR,9,7,1,added,1,0,Config/subscriptions.txt,low,0
FantasyFootballAnalyticsR,9,7,65,added,65,0,Config/updateNflPlayers.R,NaN,0
FantasyFootballAnalyticsR,9,7,50,added,50,0,Config/updateYahooPlayers.R,NaN,0
FantasyFootballAnalyticsR,9,7,11269,added,11269,0,Data/Posts/players.csv,low,0
FantasyFootballAnalyticsR,9,7,1951,added,1951,0,Data/Posts/playerteams.csv,low,0
FantasyFootballAnalyticsR,9,7,1116,added,1116,0,Data/Posts/qbprojections.csv,low,0
FantasyFootballAnalyticsR,9,7,2479,added,2479,0,Data/Posts/rbprojections.csv,low,0
FantasyFootballAnalyticsR,9,7,1714,added,1714,0,Data/Posts/teprojections.csv,low,0
FantasyFootballAnalyticsR,9,7,3271,added,3271,0,Data/Posts/wrprojections.csv,low,0
FantasyFootballAnalyticsR,9,7,0,added,0,0,Data/aggProj.RData,NaN,0
FantasyFootballAnalyticsR,9,7,6815,added,6815,0,Data/aggProj.csv,low,0
FantasyFootballAnalyticsR,9,7,0,added,0,0,Data/totProj.RData,NaN,0
FantasyFootballAnalyticsR,9,7,6815,added,6815,0,Data/totProj.csv,low,0
FantasyFootballAnalyticsR,9,7,0,added,0,0,Figures/passCompDiffernce.png,low,0
FantasyFootballAnalyticsR,9,7,0,added,0,0,Figures/passTdDiffernce.png,low,0
FantasyFootballAnalyticsR,9,7,0,added,0,0,Figures/passYdsDiffernce.png,low,0
FantasyFootballAnalyticsR,9,7,27,modified,24,3,R Scripts/Functions/League Settings.R,NaN,1
FantasyFootballAnalyticsR,9,7,146,added,146,0,R Scripts/Functions/mySqlDbFunctions.R,NaN,0
FantasyFootballAnalyticsR,9,7,66,added,66,0,R Scripts/Functions/nflPlayers.R,NaN,0
FantasyFootballAnalyticsR,9,7,368,added,368,0,R Scripts/Functions/packageFunctions.R,NaN,0
FantasyFootballAnalyticsR,9,7,147,modified,120,27,R Scripts/Functions/scrapeFunctions.R,NaN,0
FantasyFootballAnalyticsR,9,7,98,added,98,0,R Scripts/Posts/balanceAnalysis.R,NaN,0
FantasyFootballAnalyticsR,9,7,479,added,479,0,R Scripts/Projections/getProjections.R,NaN,0
FantasyFootballAnalyticsR,9,7,332,modified,278,54,R Scripts/Projections/statProjections.R,NaN,0
FantasyFootballAnalyticsR,8,4,0,added,0,0,Data/consolidatedProj.RData,NaN,0
FantasyFootballAnalyticsR,8,4,34,modified,33,1,R Scripts/Functions/Functions.R,NaN,0
FantasyFootballAnalyticsR,8,4,25,modified,23,2,R Scripts/Functions/League Settings.R,NaN,1
FantasyFootballAnalyticsR,8,4,133,added,133,0,R Scripts/Functions/adjustedWilcox.R,NaN,0
FantasyFootballAnalyticsR,8,4,67,modified,61,6,R Scripts/Projections/statProjections.R,NaN,0
FantasyFootballAnalyticsR,7,4,0,added,0,0,Config/nflPlayers.RData,NaN,0
FantasyFootballAnalyticsR,7,4,0,added,0,0,Config/siteConfig.RData,NaN,0
FantasyFootballAnalyticsR,7,4,33,added,33,0,Data/NFLTeams.csv,low,0
FantasyFootballAnalyticsR,7,4,22,added,22,0,Data/NameCorrections.csv,low,0
FantasyFootballAnalyticsR,7,4,2,modified,1,1,R Scripts/Functions/League Settings.R,NaN,1
FantasyFootballAnalyticsR,7,4,210,added,210,0,R Scripts/Functions/scrapeFunctions.R,NaN,0
FantasyFootballAnalyticsR,7,4,62,added,62,0,R Scripts/Projections/statProjections.R,NaN,0
FantasyFootballAnalyticsR,6,1,346,added,346,0,R Scripts/Weekly Projections/Gold Mining/wr_tiers,NaN,0
FantasyFootballAnalyticsR,5,1,113,added,113,0,VBAYahooScrape,NaN,0
FantasyFootballAnalyticsR,4,1,214,added,214,0,RBData.txt,low,0
FantasyFootballAnalyticsR,3,1,197,added,197,0,R Scripts/Posts/Big_Workload.R,NaN,0
FantasyFootballAnalyticsR,2,1,216,added,216,0,R Scripts/Posts/Big_Workload_Nearby.R,NaN,0
soccer-cli,135,2,3,modified,2,1,soccer/leagueids.py,high,0
soccer-cli,135,2,288,modified,288,0,soccer/teams.json,medium,0
soccer-cli,134,1,3,modified,2,1,soccer/leagueids.py,high,1
soccer-cli,132,1,2,modified,1,1,soccer/main.py,high,0
soccer-cli,123,2,6,modified,3,3,soccer/writers.py,high,0
soccer-cli,122,1,25,modified,12,13,soccer/leagueids.py,high,1
soccer-cli,122,1,4,modified,2,2,soccer/teams.json,medium,0
soccer-cli,117,1,2,modified,1,1,README.md,low,0
soccer-cli,116,1,2,modified,1,1,README.md,low,0
soccer-cli,114,2,14,modified,14,0,README.md,low,0
soccer-cli,114,2,112,modified,106,6,tests/test_request_handler.py,high,0
soccer-cli,113,3,1,modified,1,0,requirements.txt,low,0
soccer-cli,113,3,7,added,7,0,tests/mock_response.py,high,0
soccer-cli,113,3,13,modified,3,10,tests/test_load_data.py,high,0
soccer-cli,113,3,165,added,165,0,tests/test_request_handler.py,high,0
soccer-cli,112,1,1,modified,1,0,.gitignore,low,0
soccer-cli,112,1,21,modified,12,9,soccer/main.py,high,0
soccer-cli,112,1,18,modified,9,9,soccer/request_handler.py,high,0
soccer-cli,112,1,10,modified,7,3,tests/test_load_data.py,high,0
soccer-cli,110,2,141,modified,9,132,soccer/main.py,high,0
soccer-cli,110,2,134,added,134,0,soccer/request_handler.py,high,0
soccer-cli,110,2,45,added,45,0,tests/test_load_data.py,high,0
soccer-cli,108,2,2,modified,1,1,README.md,low,0
soccer-cli,108,2,2,modified,1,1,soccer/main.py,high,0
soccer-cli,107,2,8,modified,4,4,soccer/leagueids.py,high,1
soccer-cli,107,2,17,modified,11,6,soccer/leagueproperties.py,high,0
soccer-cli,107,2,14,modified,7,7,soccer/main.py,high,0
soccer-cli,106,1,2,modified,1,1,soccer/main.py,high,0
soccer-cli,104,1,2,modified,1,1,README.md,low,0
soccer-cli,103,1,2,modified,1,1,soccer/main.py,high,1
soccer-cli,101,1,2,modified,1,1,README.md,low,1
soccer-cli,94,1,24,modified,12,12,soccer/leagueids.py,high,1
soccer-cli,93,3,3,modified,2,1,soccer/leagueids.py,high,2
soccer-cli,93,3,218,modified,217,1,soccer/teams.json,medium,1
soccer-cli,92,3,3,modified,2,1,soccer/leagueids.py,high,3
soccer-cli,92,3,218,modified,217,1,soccer/teams.json,medium,2
soccer-cli,89,1,4,modified,2,2,README.md,low,1
soccer-cli,89,1,2,modified,1,1,soccer/main.py,high,1
soccer-cli,88,5,13,modified,11,2,soccer/main.py,high,1
soccer-cli,86,1,6,modified,6,0,README.md,low,1
soccer-cli,86,1,15,added,15,0,soccer/jsonhandler.py,high,0
soccer-cli,86,1,15,removed,0,15,soccer/leagueids.py,high,3
soccer-cli,86,1,62,removed,0,62,soccer/leagueproperties.py,high,0
soccer-cli,86,1,238,added,238,0,soccer/leagues.json,medium,0
soccer-cli,86,1,42,modified,23,19,soccer/main.py,high,1
soccer-cli,86,1,1184,modified,682,502,soccer/teams.json,medium,2
soccer-cli,86,1,5,modified,1,4,soccer/writers.py,high,0
soccer-cli,84,5,3,modified,3,0,requirements.txt,low,0
soccer-cli,84,5,15,modified,9,6,soccer/main.py,high,1
soccer-cli,84,5,0,added,0,0,tests/__init__.py,high,0
soccer-cli,84,5,1,added,1,0,tests/cassettes/League_standings.json,medium,0
soccer-cli,84,5,1,added,1,0,tests/cassettes/Scores_live_games.json,medium,0
soccer-cli,84,5,1,added,1,0,tests/cassettes/Scores_specific_league.json,medium,0
soccer-cli,84,5,1,added,1,0,tests/cassettes/Team_invalid.json,medium,0
soccer-cli,84,5,1,added,1,0,tests/cassettes/Team_player_names.json,medium,0
soccer-cli,84,5,1,added,1,0,tests/cassettes/Team_scores.json,medium,0
soccer-cli,84,5,1,added,1,0,tests/cassettes/Team_upcoming_games.json,medium,0
soccer-cli,83,3,2,modified,1,1,README.md,low,1
soccer-cli,83,3,49,modified,29,20,soccer/main.py,high,1
soccer-cli,83,3,136,removed,0,136,soccer/teamcodes.json,medium,0
soccer-cli,83,3,85,removed,0,85,soccer/teamnames.py,high,0
soccer-cli,83,3,2254,added,2254,0,soccer/teams.json,medium,2
soccer-cli,82,4,42,modified,28,14,README.md,low,2
soccer-cli,43,7,12,modified,8,4,README.md,low,2
soccer-cli,40,3,4,modified,2,2,.gitignore,low,0
soccer-cli,40,3,17,modified,15,2,soccer/main.py,high,2
soccer-cli,39,3,174,modified,100,74,soccer/main.py,high,2
soccer-cli,38,2,2,modified,1,1,README.md,low,2
soccer-cli,38,2,0,renamed,0,0,soccer/teamcodes.json,medium,0
soccer-cli,33,1,3,modified,1,2,.gitignore,low,1
soccer-cli,29,1,4,modified,2,2,README.md,low,2
soccer-cli,28,5,266,modified,133,133,teamcodes.json,medium,0
soccer-cli,8,0,25,removed,0,25,.gitignore,low,2
soccer-cli,8,0,133,added,133,0,football/__init__.py,high,1
soccer-cli,8,0,2,added,2,0,football/org.football-data.api.json,medium,1
soccer-cli,8,0,9,removed,0,9,leagueids.py,high,1
soccer-cli,8,0,1,removed,0,1,liveapi.py,high,1
soccer-cli,8,0,194,removed,0,194,main.py,high,2
soccer-cli,8,0,6,modified,2,4,requirements.txt,low,1
soccer-cli,8,0,56,modified,14,42,setup.py,high,3
soccer-cli,8,0,136,removed,0,136,teamcodes.json,medium,1
soccer-cli,8,0,84,removed,0,84,teamnames.py,high,1
soccer-cli,8,0,2,removed,0,2,tests/test.py,high,1
soccer-cli,9,1,2,modified,1,1,README.md,low,2
soccer-cli,4,0,8,modified,4,4,README.md,low,2
soccer-cli,2,0,2,modified,1,1,README.md,low,2
football-cli,62,1,1,added,1,0,.npmrc,NaN,0
football-cli,62,1,2894,removed,0,2894,package-lock.json,medium,0
football-cli,62,1,2079,added,2079,0,yarn.lock,NaN,0
football-cli,61,4,27,modified,16,11,.eslintrc,NaN,0
football-cli,61,4,18,modified,4,14,.vscode/settings.json,medium,0
football-cli,61,4,11,modified,7,4,package.json,medium,0
football-cli,60,1,2,modified,1,1,.github/CONTRIBUTING.md,low,0
football-cli,60,1,14,modified,7,7,README.md,low,0
football-cli,60,1,4,modified,2,2,constants.js,high,0
football-cli,60,1,6,modified,3,3,package.json,medium,0
football-cli,59,2,12,modified,5,7,cmds/config.js,high,0
football-cli,59,2,52,modified,25,27,cmds/fixtures.js,high,0
football-cli,59,2,18,modified,8,10,cmds/lists.js,high,0
football-cli,59,2,42,modified,20,22,cmds/scores.js,high,0
football-cli,59,2,38,modified,18,20,cmds/standings.js,high,0
football-cli,59,2,2,modified,1,1,constants.js,high,0
football-cli,59,2,86,modified,31,55,leagueIds.json,medium,0
football-cli,58,2,13,modified,3,10,cmds/fixtures.js,high,0
football-cli,58,2,13,modified,3,10,cmds/scores.js,high,0
football-cli,58,2,13,modified,3,10,cmds/standings.js,high,0
football-cli,58,2,4,modified,2,2,cmds/utils/helpers.js,high,0
football-cli,58,2,14,added,14,0,cmds/utils/requests.js,high,0
football-cli,58,2,9,added,9,0,constants.js,high,0
football-cli,58,2,5,removed,0,5,constants.json,medium,0
football-cli,57,1,6,modified,3,3,cmds/utils/helpers.js,high,0
football-cli,56,2,4,modified,3,1,.travis.yml,medium,0
football-cli,56,2,19,added,19,0,__tests__/lists.test.js,high,0
football-cli,56,2,6,modified,5,1,cmds/lists.js,high,0
football-cli,56,2,13,added,13,0,cmds/utils/logging.js,high,0
football-cli,56,2,5224,modified,4704,520,package-lock.json,medium,0
football-cli,56,2,8,modified,6,2,package.json,medium,0
football-cli,55,1,1,modified,1,0,.gitignore,low,0
football-cli,55,1,30,modified,17,13,cmds/utils/helpers.js,high,0
football-cli,54,3,3,modified,3,0,.travis.yml,medium,0
football-cli,53,1,4,modified,2,2,cmds/fixtures.js,high,0
football-cli,53,1,2,modified,1,1,cmds/lists.js,high,0
football-cli,53,1,2,modified,1,1,cmds/scores.js,high,0
football-cli,53,1,4,modified,2,2,cmds/standings.js,high,0
football-cli,52,3,2,modified,1,1,.travis.yml,medium,0
football-cli,52,3,1,modified,1,0,cli.js,high,0
football-cli,52,3,4,modified,2,2,cmds/config.js,high,0
football-cli,52,3,7,modified,3,4,cmds/fixtures.js,high,0
football-cli,52,3,6,modified,3,3,cmds/lists.js,high,0
football-cli,52,3,3,modified,1,2,cmds/scores.js,high,0
football-cli,52,3,7,modified,3,4,cmds/standings.js,high,0
football-cli,52,3,658,modified,343,315,package-lock.json,medium,0
football-cli,52,3,12,modified,6,6,package.json,medium,0
football-cli,51,2,2,modified,1,1,cmds/config.js,high,0
football-cli,51,2,2,modified,1,1,cmds/fixtures.js,high,0
football-cli,51,2,2,modified,1,1,cmds/lists.js,high,0
football-cli,51,2,2,modified,1,1,cmds/scores.js,high,0
football-cli,51,2,2,modified,1,1,cmds/standings.js,high,0
football-cli,51,2,4,renamed,2,2,cmds/utils/helpers.js,high,0
football-cli,51,2,2,modified,1,1,package.json,medium,0
football-cli,50,2,17,added,17,0,.vscode/settings.json,medium,0
football-cli,49,2,6,modified,3,3,cmds/config.js,high,0
football-cli,49,2,28,modified,14,14,cmds/fixtures.js,high,0
football-cli,49,2,12,modified,6,6,cmds/lists.js,high,0
football-cli,49,2,20,modified,10,10,cmds/scores.js,high,0
football-cli,49,2,16,modified,8,8,cmds/standings.js,high,0
football-cli,49,2,1,modified,0,1,helpers.js,high,0
football-cli,49,2,2492,modified,1099,1393,package-lock.json,medium,0
football-cli,49,2,2,modified,1,1,package.json,medium,0
football-cli,46,6,2,modified,1,1,package.json,medium,0
football-cli,43,18,6,modified,2,4,cmds/config.js,high,0
football-cli,43,18,63,modified,37,26,cmds/fixtures.js,high,0
football-cli,43,18,11,modified,5,6,cmds/lists.js,high,0
football-cli,43,18,45,modified,30,15,cmds/scores.js,high,0
football-cli,43,18,25,modified,19,6,cmds/standings.js,high,0
football-cli,43,18,125,modified,113,12,helpers.js,high,0
football-cli,43,18,18,modified,18,0,package-lock.json,medium,0
football-cli,43,18,2,modified,2,0,package.json,medium,0
football-cli,42,1,12,modified,6,6,helpers.js,high,0
football-cli,40,2,1,modified,1,0,cli.js,high,0
football-cli,40,2,2,modified,1,1,package-lock.json,medium,0
football-cli,40,2,2,modified,1,1,package.json,medium,0
football-cli,37,1,4,modified,2,2,helpers.js,high,1
football-cli,34,1,58,modified,23,35,cli.js,high,0
football-cli,34,1,3,modified,0,3,helpers.js,high,1
football-cli,33,1,2,modified,1,1,helpers.js,high,1
football-cli,32,1,17,modified,12,5,cli.js,high,0
football-cli,32,1,3,modified,2,1,constants.json,medium,0
football-cli,32,1,20,modified,0,20,helpers.js,high,1
football-cli,31,1,2,modified,1,1,cli.js,high,0
football-cli,31,1,2,modified,1,1,helpers.js,high,1
football-cli,31,1,92,modified,40,52,package-lock.json,medium,0
football-cli,31,1,2,modified,1,1,package.json,medium,0
football-cli,27,1,6,modified,3,3,package-lock.json,medium,0
football-cli,27,1,2,modified,1,1,package.json,medium,0
football-cli,26,2,3,modified,2,1,README.md,low,0
football-cli,26,2,8,modified,6,2,cli.js,high,0
football-cli,25,1,2,modified,1,1,cli.js,high,0
football-cli,25,1,2,modified,1,1,helpers.js,high,1
football-cli,25,1,71,modified,59,12,package-lock.json,medium,0
football-cli,25,1,2,modified,1,1,package.json,medium,0
football-cli,7,0,18,added,18,0,snapcraft.yaml,medium,1
football.json,16,1,1,modified,0,1,2016-17/fr.1.clubs.json,medium,0
football.json,14,1,104,added,104,0,2016-17/fr.1.clubs.json,medium,0
football.json,12,16,722,modified,361,361,2015-16/de.1.json,medium,1
football.json,11,15,722,modified,361,361,2015-16/de.1.json,medium,1
football.json,10,14,686,modified,343,343,2015-16/de.1.json,medium,1
football.json,9,11,650,modified,325,325,2015-16/de.1.json,medium,1
football.json,8,9,614,modified,307,307,2015-16/de.1.json,medium,1
football.json,7,4,160,modified,80,80,2015-16/en.1.json,medium,0
football.json,6,5,546,modified,273,273,2015-16/de.1.json,medium,1
football.json,5,1,182,modified,91,91,2015-16/de.1.json,medium,1
football.json,3,5,15,modified,15,0,2013-14/en.1.json,medium,0
football.json,3,5,15,modified,15,0,2014-15/de.1.json,medium,0
football.json,3,5,30,modified,30,0,2014-15/es.1.json,medium,0
football.json,3,5,15,modified,15,0,2014-15/it.1.json,medium,0
football.json,2,0,5,modified,2,3,README.md,low,1
openfootball.github.io,2,1,8,modified,4,4,index.md,low,0
espnff,56,1,4,modified,4,0,CHANGELOG.md,low,0
espnff,56,1,11,modified,10,1,espnff/league.py,high,0
espnff,54,1,1,modified,1,0,espnff/team.py,high,0
espnff,51,0,114,modified,113,1,.gitignore,low,1
espnff,51,0,6,modified,2,4,README.md,low,1
espnff,34,2,103,modified,102,1,.gitignore,low,1
espnff,34,2,21,modified,12,9,espnff/__init__.py,high,0
espnff,34,2,45,added,45,0,espnff/client.py,high,0
espnff,34,2,4,modified,4,0,espnff/exception.py,high,0
espnff,34,2,2,modified,1,1,espnff/league.py,high,3
espnff,34,2,108,added,108,0,tests/test_client.json,medium,0
espnff,34,2,30,added,30,0,tests/test_client.py,high,0
espnff,32,1,29,modified,27,2,espnff/league.py,high,3
espnff,29,1,14,modified,12,2,espnff/league.py,high,3
espnff,27,1,0,removed,0,0,espnff/tests/__init__.py,high,0
espnff,27,1,12050,removed,0,12050,espnff/tests/test_league.json,medium,0
espnff,27,1,49,removed,0,49,espnff/tests/test_league.py,high,0
espnff,27,1,872,removed,0,872,espnff/tests/test_scoreboard.json,medium,0
espnff,27,1,94,removed,0,94,espnff/tests/test_scoreboard.py,high,0
espnff,27,1,35,removed,0,35,espnff/tests/test_utils.py,high,0
espnff,26,8,5,modified,5,0,CHANGELOG.md,low,0
espnff,26,8,2,modified,1,1,README.rst,medium,0
espnff,26,8,19,modified,17,2,espnff/__init__.py,high,0
espnff,26,8,290,removed,0,290,espnff/espnff.py,high,0
espnff,26,8,14,added,14,0,espnff/exception.py,high,0
espnff,26,8,123,added,123,0,espnff/league.py,high,3
espnff,26,8,26,added,26,0,espnff/matchup.py,high,0
espnff,26,8,3,added,3,0,espnff/player.py,high,0
espnff,26,8,88,added,88,0,espnff/settings.py,high,0
espnff,26,8,45,added,45,0,espnff/team.py,high,3
espnff,26,8,1,modified,0,1,espnff/tests/test_league.json,medium,0
espnff,26,8,49,added,49,0,espnff/tests/test_league.py,high,0
espnff,26,8,83,renamed,5,78,espnff/tests/test_scoreboard.py,high,0
espnff,26,8,0,added,0,0,tests/__init__.py,high,0
espnff,26,8,12050,added,12050,0,tests/test_league.json,medium,0
espnff,26,8,49,added,49,0,tests/test_league.py,high,0
espnff,26,8,872,added,872,0,tests/test_scoreboard.json,medium,0
espnff,26,8,94,added,94,0,tests/test_scoreboard.py,high,0
espnff,26,8,35,added,35,0,tests/test_utils.py,high,0
espnff,25,8,2,modified,2,0,CHANGELOG.md,low,0
espnff,25,8,2,modified,1,1,README.rst,medium,0
espnff,25,8,19,modified,17,2,espnff/__init__.py,high,0
espnff,25,8,293,removed,0,293,espnff/espnff.py,high,0
espnff,25,8,14,added,14,0,espnff/exception.py,high,0
espnff,25,8,123,added,123,0,espnff/league.py,high,3
espnff,25,8,26,added,26,0,espnff/matchup.py,high,0
espnff,25,8,88,added,88,0,espnff/settings.py,high,0
espnff,25,8,40,added,40,0,espnff/team.py,high,3
espnff,25,8,8,modified,4,4,espnff/tests/test_espnff.py,high,0
espnff,24,7,19,modified,17,2,espnff/__init__.py,high,1
espnff,24,7,293,removed,0,293,espnff/espnff.py,high,1
espnff,24,7,14,added,14,0,espnff/exception.py,high,1
espnff,24,7,123,added,123,0,espnff/league.py,high,4
espnff,24,7,26,added,26,0,espnff/matchup.py,high,1
espnff,24,7,88,added,88,0,espnff/settings.py,high,1
espnff,24,7,40,added,40,0,espnff/team.py,high,4
espnff,24,7,8,modified,4,4,espnff/tests/test_espnff.py,high,1
espnff,23,4,3,modified,3,0,CHANGELOG.md,low,0
espnff,23,4,5,modified,4,1,espnff/espnff.py,high,1
espnff,23,4,1,modified,0,1,espnff/tests/test_league.json,medium,0
espnff,21,1,5,modified,4,1,CHANGELOG.md,low,0
espnff,21,1,2,modified,1,1,README.md,low,1
espnff,21,1,2,modified,1,1,setup.py,high,0
espnff,20,4,1,modified,1,0,.travis.yml,medium,0
espnff,20,4,5,modified,5,0,CHANGELOG.md,low,0
espnff,20,4,21,modified,15,6,espnff/espnff.py,high,1
espnff,17,1,9,modified,4,5,CHANGELOG.md,low,0
espnff,17,1,2,modified,1,1,README.md,low,1
espnff,17,1,2,modified,1,1,setup.py,high,0
espnff,16,2,1,modified,1,0,CHANGELOG.md,low,0
espnff,16,2,6,modified,6,0,README.md,low,1
espnff,16,2,6,modified,6,0,README.rst,medium,0
espnff,16,2,57,modified,57,0,espnff/espnff.py,high,1
espnff,15,5,2,modified,1,1,.travis.yml,medium,0
espnff,15,5,9,modified,8,1,CHANGELOG.md,low,0
espnff,15,5,38,modified,38,0,README.md,low,1
espnff,15,5,39,modified,39,0,README.rst,medium,0
espnff,15,5,25,modified,25,0,espnff/espnff.py,high,1
espnff,14,2,7,modified,7,0,espnff/espnff.py,high,2
espnff,13,1,8,modified,6,2,CHANGELOG.md,low,0
espnff,13,1,2,modified,1,1,README.md,low,1
espnff,13,1,2,modified,1,1,setup.py,high,0
espnff,12,1,9,modified,7,2,espnff/espnff.py,high,2
espnff,10,1,7,modified,6,1,CHANGELOG.md,low,0
espnff,10,1,2,modified,1,1,README.md,low,1
espnff,10,1,2,modified,1,1,setup.py,high,0
espnff,9,3,5,modified,4,1,CHANGELOG.md,low,0
espnff,9,3,17,modified,10,7,README.md,low,1
espnff,9,3,13,modified,8,5,README.rst,medium,0
espnff,9,3,2,modified,1,1,setup.py,high,0
espnff,8,3,2,modified,2,0,CHANGELOG.md,low,0
espnff,8,3,30,modified,30,0,README.rst,medium,0
espnff,8,3,4,modified,2,2,espnff/utils.py,high,0
espnff,6,1,5,modified,4,1,CHANGELOG.md,low,0
espnff,6,1,2,modified,1,1,README.md,low,1
espnff,6,1,2,modified,1,1,setup.py,high,0
espnff,5,14,7,modified,7,0,CHANGELOG.md,low,0
espnff,5,14,29,modified,29,0,README.md,low,1
espnff,5,14,142,added,142,0,README.rst,medium,0
espnff,5,14,72,modified,61,11,espnff/espnff.py,high,2
espnff,5,14,81,modified,81,0,espnff/tests/test_espnff.py,high,1
espnff,5,14,872,added,872,0,espnff/tests/test_scoreboard.json,medium,0
espnff,5,14,28,modified,4,24,espnff/utils.py,high,0
espnff,5,14,2,modified,1,1,setup.py,high,0
espnff,4,1,6,modified,5,1,CHANGELOG.md,low,0
espnff,4,1,6,modified,3,3,README.md,low,1
espnff,4,1,2,modified,1,1,setup.py,high,0
espnff,3,19,12,modified,9,3,CHANGELOG.md,low,0
espnff,3,19,81,modified,61,20,espnff/espnff.py,high,2
espnff,3,19,48,added,48,0,espnff/tests/test_espnff.py,high,1
espnff,3,19,12051,added,12051,0,espnff/tests/test_league.json,medium,0
espnff,3,19,17,modified,17,0,espnff/utils.py,high,0
espnff,3,19,2,modified,1,1,setup.py,high,0
football-data-collection,3,2,0,removed,0,0,footballData/footballData/__init__.pyc,NaN,0
football-data-collection,3,2,2,modified,1,1,footballData/footballData/items.py,high,0
football-data-collection,3,2,0,removed,0,0,footballData/footballData/items.pyc,NaN,0
football-data-collection,3,2,10,modified,5,5,footballData/footballData/pipelines.py,high,0
football-data-collection,3,2,0,removed,0,0,footballData/footballData/pipelines.pyc,NaN,0
football-data-collection,3,2,9,modified,5,4,footballData/footballData/settings.py,high,0
football-data-collection,3,2,0,removed,0,0,footballData/footballData/settings.pyc,NaN,0
football-data-collection,3,2,0,removed,0,0,footballData/footballData/spiders/__init__.pyc,NaN,0
football-data-collection,3,2,83,modified,41,42,footballData/footballData/spiders/matchcrawler.py,high,0
football-data-collection,3,2,0,removed,0,0,footballData/footballData/spiders/matchcrawler.pyc,NaN,0
football-data-collection,3,2,2,modified,1,1,footballData/footballData/spiders/playercrawler.py,high,0
football-data-collection,3,2,0,removed,0,0,footballData/footballData/spiders/playercrawler.pyc,NaN,0
footballNotifier,1,1,8,modified,4,4,README.md,low,0
ff_bot,25,7,48,modified,36,12,README.md,low,0
ff_bot,25,7,6,modified,5,1,app.json,medium,0
ff_bot,25,7,57,modified,51,6,ff_bot/ff_bot.py,high,0
ff_bot,25,7,29,added,29,0,ff_bot/tests/test_discordbot.py,high,0
ff_bot,23,9,54,modified,42,12,README.md,low,0
ff_bot,23,9,6,modified,5,1,app.json,medium,0
ff_bot,23,9,55,modified,50,5,ff_bot/ff_bot.py,high,0
ff_bot,23,9,29,added,29,0,ff_bot/tests/test_discordbot.py,high,0
ff_bot,21,1,4,modified,2,2,ff_bot/ff_bot.py,high,0
ff_bot,20,8,59,modified,48,11,README.md,low,0
ff_bot,20,8,4,modified,4,0,app.json,medium,0
ff_bot,20,8,66,modified,59,7,ff_bot/ff_bot.py,high,0
ff_bot,20,8,29,added,29,0,ff_bot/tests/test_slackbot.py,high,0
ff_bot,17,15,63,modified,50,13,README.md,low,0
ff_bot,17,15,10,modified,7,3,app.json,medium,0
ff_bot,17,15,58,modified,50,8,ff_bot/ff_bot.py,high,0
ff_bot,17,15,29,added,29,0,ff_bot/tests/test_slackbot.py,high,0
ff_bot,15,9,4,modified,4,0,README.md,low,0
ff_bot,15,9,2,modified,1,1,app.json,medium,0
ff_bot,15,9,97,modified,53,44,ff_bot/ff_bot.py,high,0
ff_bot,12,0,1,modified,1,0,README.md,low,1
ff_bot,11,2,12,modified,6,6,ff_bot/ff_bot.py,high,0
ff_bot,8,1,69,modified,64,5,ff_bot/ff_bot.py,high,0
ff_bot,7,2,33,modified,26,7,ff_bot/ff_bot.py,high,0
NFL_Roster,7,0,2,modified,1,1,README2.md,low,0
NFL_Roster,6,1,4,modified,4,0,README2.md,low,0
NFL_Roster,5,17,3,added,3,0,app.js,high,1
NFL_Roster,5,17,2,added,2,0,debug.log,low,1
NFL_Roster,5,17,90,added,90,0,index.html,medium,1
NFL_Roster,5,17,102,added,102,0,players-controller.js,high,1
NFL_Roster,5,17,169,added,169,0,players-service.js,high,1
NFL_Roster,5,17,55,added,55,0,style.css,medium,1
NFL_Roster,4,1,14,renamed,10,4,README2.md,low,0
NFL_Roster,3,1,36,removed,0,36,README.md,low,0
NFL_Roster,3,1,44,added,44,0,README1.md,low,0
NFL_Roster,2,6,36,modified,18,18,PlayerService.md,low,0
NFL_Roster,2,6,29,modified,15,14,README.md,low,0
NFL_Roster,1,1,15,added,15,0,site.css,medium,1
superbowleto,292,1,14,added,14,0,src/providers/bradesco/temp.js,high,0
superbowleto,292,1,19,modified,17,2,src/resources/boleto/service.js,high,0
superbowleto,292,1,22,added,22,0,test/unit/providers/bradesco/temp.js,high,0
superbowleto,291,1,4,modified,2,2,test/unit/providers/bradesco/index.js,high,0
superbowleto,290,1,2,modified,1,1,Makefile,high,0
superbowleto,290,1,13,modified,13,0,docker-compose.yml,medium,0
superbowleto,288,1,114,modified,57,57,README.md,low,0
superbowleto,288,1,16,removed,0,16,docs/diagrams/4-boleto-process-queue.mmd,NaN,0
superbowleto,288,1,18,removed,0,18,docs/diagrams/5-boleto-register.mmd,NaN,0
superbowleto,288,1,1,renamed,0,1,docs/diagrams/server/1a-post-boletos.mmd,NaN,0
superbowleto,288,1,1,renamed,0,1,docs/diagrams/server/1b-post-boletos.mmd,NaN,0
superbowleto,288,1,1,renamed,0,1,docs/diagrams/server/2-get-boletos.mmd,NaN,0
superbowleto,288,1,3,renamed,1,2,docs/diagrams/server/3-get-boletos-id.mmd,NaN,0
superbowleto,288,1,16,added,16,0,docs/diagrams/worker/1-process-boletos-to-register-queue.mmd,NaN,0
superbowleto,287,6,2,modified,1,1,src/lib/logger/index.js,high,0
superbowleto,287,6,6,modified,3,3,src/providers/bradesco/index.js,high,0
superbowleto,287,6,1,modified,1,0,src/server/index.js,high,0
superbowleto,286,1,2,modified,1,1,src/lib/logger/index.js,high,0
superbowleto,285,1,6,modified,3,3,src/providers/bradesco/index.js,high,0
superbowleto,284,1,1,modified,1,0,src/server/index.js,high,0
superbowleto,283,1,3,modified,3,0,.env.example,medium,0
superbowleto,283,1,7,added,7,0,newrelic.js,high,0
superbowleto,283,1,1,modified,1,0,package.json,medium,0
superbowleto,283,1,4,modified,4,0,src/bin/server.js,high,0
superbowleto,283,1,3,modified,3,0,src/bin/worker.js,high,0
superbowleto,283,1,10,added,10,0,src/lib/instrumentation/index.js,high,0
superbowleto,282,3,1,modified,1,0,.env.example,medium,0
superbowleto,282,3,49,modified,36,13,src/bin/worker.js,high,0
superbowleto,282,3,11,modified,6,5,src/lib/credentials/index.js,high,0
superbowleto,282,3,2,modified,1,1,src/resources/boleto/service.js,high,0
superbowleto,281,5,6,modified,3,3,.env.example,medium,0
superbowleto,281,5,24,modified,14,10,.travis.yml,medium,0
superbowleto,281,5,2,modified,1,1,Dockerfile,low,0
superbowleto,281,5,3,modified,2,1,Dockerfile.server,NaN,0
superbowleto,281,5,3,modified,2,1,Dockerfile.worker,NaN,0
superbowleto,281,5,16,modified,13,3,docker-compose.yml,medium,0
superbowleto,281,5,1,modified,1,0,package.json,medium,0
superbowleto,281,5,59,added,59,0,script/deploy.sh,high,0
superbowleto,281,5,12,added,12,0,script/start_server.sh,high,0
superbowleto,281,5,9,added,9,0,script/start_worker.sh,high,0
superbowleto,281,5,8,modified,4,4,src/bin/server.js,high,0
superbowleto,281,5,8,modified,4,4,src/bin/worker.js,high,0
superbowleto,281,5,6,modified,6,0,src/database/index.js,high,0
superbowleto,281,5,11,added,11,0,src/middlewares/redirect-http.js,high,0
superbowleto,281,5,7,modified,5,2,src/server/index.js,high,0
superbowleto,280,1,28,modified,16,12,Dockerfile.server,NaN,0
superbowleto,280,1,28,modified,16,12,Dockerfile.worker,NaN,0
superbowleto,279,2,0,renamed,0,0,Dockerfile,low,0
superbowleto,279,2,2,renamed,2,0,Dockerfile.server,NaN,0
superbowleto,279,2,21,added,21,0,Dockerfile.worker,NaN,0
superbowleto,279,2,12,modified,3,9,docker-compose.yml,medium,0
superbowleto,278,1,6,added,6,0,.env.example,medium,0
superbowleto,278,1,4780,modified,1113,3667,package-lock.json,medium,0
superbowleto,278,1,1,modified,1,0,package.json,medium,0
superbowleto,277,1,2660,modified,1093,1567,package-lock.json,medium,1
superbowleto,277,1,4,modified,2,2,package.json,medium,1
superbowleto,276,2,0,renamed,0,0,Dockerfile.development,NaN,0
superbowleto,276,2,19,added,19,0,Dockerfile.production,NaN,0
superbowleto,276,2,12,modified,9,3,docker-compose.yml,medium,0
superbowleto,276,2,4,modified,2,2,package.json,medium,1
superbowleto,274,4,15,modified,15,0,docker-compose.yml,medium,0
superbowleto,270,5,4,modified,2,2,README.md,low,0
superbowleto,270,5,4,modified,3,1,docker-compose.yml,medium,0
superbowleto,270,5,1,modified,1,0,package.json,medium,1
superbowleto,268,1,2,modified,1,1,package.json,medium,1
superbowleto,267,3,1,modified,1,0,package.json,medium,1
superbowleto,266,1,12,modified,8,4,src/providers/bradesco/response-codes.ts,NaN,0
superbowleto,265,2,2,modified,2,0,Dockerfile,low,0
superbowleto,265,2,15,modified,15,0,Makefile,high,0
superbowleto,265,2,29,modified,27,2,README.md,low,0
superbowleto,265,2,19,modified,19,0,docker-compose.yml,medium,0
superbowleto,265,2,3,modified,1,2,package.json,medium,1
superbowleto,265,2,2,modified,1,1,script/setup,NaN,0
superbowleto,264,1,2,modified,2,0,package.json,medium,1
superbowleto,264,1,12,added,12,0,src/bin/server.js,high,0
superbowleto,263,2,2,modified,1,1,Dockerfile,low,0
superbowleto,263,2,11,modified,5,6,README.md,low,0
superbowleto,263,2,2,modified,1,1,docker-compose.yml,medium,0
superbowleto,263,2,1237,modified,0,1237,package-lock.json,medium,1
superbowleto,263,2,4,modified,1,3,package.json,medium,1
superbowleto,263,2,50,removed,0,50,serverless.yml,medium,0
superbowleto,263,2,5129,removed,0,5129,yarn.lock,NaN,0
superbowleto,262,11,18,modified,5,13,.eslintrc,NaN,0
superbowleto,262,11,1,modified,0,1,.travis.yml,medium,0
superbowleto,262,11,2,modified,1,1,Dockerfile,low,0
superbowleto,262,11,3482,modified,1327,2155,package-lock.json,medium,1
superbowleto,262,11,32,modified,9,23,package.json,medium,1
superbowleto,262,11,2,modified,1,1,script/setup,NaN,0
superbowleto,262,11,12,renamed,6,6,src/config/database.js,high,0
superbowleto,262,11,9,added,9,0,src/config/index.js,high,0
superbowleto,262,11,5,removed,0,5,src/config/index.ts,NaN,0
superbowleto,262,11,1,removed,0,1,src/database/models.ts,NaN,0
superbowleto,262,11,26,renamed,15,11,src/functions/database/index.js,high,0
superbowleto,262,11,25,renamed,14,11,src/lib/credentials/index.js,high,0
superbowleto,262,11,10,renamed,7,3,src/lib/database/pagination.js,high,0
superbowleto,262,11,14,added,14,0,src/lib/database/schema.js,high,0
superbowleto,262,11,9,removed,0,9,src/lib/database/schema.ts,NaN,0
superbowleto,262,11,8,added,8,0,src/lib/encoding/index.js,high,0
superbowleto,261,1,25,modified,12,13,src/resources/boleto/service.ts,NaN,1
superbowleto,260,1,1,modified,0,1,src/functions/database/index.ts,NaN,0
superbowleto,260,1,1,modified,0,1,src/lib/credentials/index.ts,NaN,0
superbowleto,260,1,1,modified,0,1,src/providers/bradesco/index.ts,NaN,0
superbowleto,260,1,1,modified,0,1,src/providers/development/index.ts,NaN,0
superbowleto,260,1,15,modified,3,12,src/resources/boleto/index.ts,NaN,0
superbowleto,260,1,10,modified,1,9,src/resources/boleto/service.ts,NaN,1
superbowleto,259,2,2,modified,1,1,package.json,medium,1
superbowleto,259,2,10,modified,9,1,src/functions/database/index.ts,NaN,0
superbowleto,259,2,10,modified,9,1,src/lib/credentials/index.ts,NaN,0
superbowleto,259,2,5,modified,4,1,src/providers/bradesco/index.ts,NaN,0
superbowleto,259,2,10,modified,9,1,src/providers/development/index.ts,NaN,0
superbowleto,259,2,63,modified,54,9,src/resources/boleto/index.ts,NaN,0
superbowleto,259,2,51,modified,45,6,src/resources/boleto/service.ts,NaN,1
superbowleto,258,1,12,added,12,0,src/database/migrations/20171107000001-add-issuer-response-code-to-boleto.js,high,0
superbowleto,258,1,7,modified,6,1,src/providers/bradesco/index.ts,NaN,0
superbowleto,258,1,5,modified,5,0,src/resources/boleto/model.ts,NaN,0
superbowleto,258,1,5,modified,2,3,src/resources/boleto/service.ts,NaN,1
superbowleto,258,1,6,modified,5,1,test/functional/boleto/create/bradesco/pending.js,high,0
superbowleto,258,1,6,modified,5,1,test/functional/boleto/create/bradesco/refused.js,high,0
superbowleto,258,1,2,modified,2,0,test/functional/boleto/create/bradesco/registered.js,high,0
superbowleto,257,1,3,modified,2,1,src/providers/bradesco/index.ts,NaN,0
superbowleto,257,1,2,modified,1,1,test/unit/providers/bradesco/index.js,high,0
superbowleto,256,5,2,modified,1,1,src/functions/database/index.ts,NaN,0
superbowleto,256,5,131,modified,50,81,src/providers/bradesco/index.ts,NaN,0
superbowleto,256,5,50,modified,30,20,src/providers/development/index.ts,NaN,0
superbowleto,256,5,63,modified,38,25,src/resources/boleto/index.ts,NaN,0
superbowleto,256,5,412,modified,216,196,src/resources/boleto/service.ts,NaN,1
superbowleto,255,1,2,modified,1,1,README.md,low,0
superbowleto,254,1,9,modified,1,8,src/resources/boleto/index.ts,NaN,0
superbowleto,254,1,79,modified,79,0,src/resources/boleto/service.ts,NaN,1
superbowleto,253,1,3,modified,2,1,src/resources/boleto/service.ts,NaN,1
superbowleto,252,1,4,modified,3,1,src/resources/boleto/service.ts,NaN,1
superbowleto,251,1,13,modified,13,0,src/resources/boleto/service.ts,NaN,1
superbowleto,250,1,10,modified,5,5,src/providers/bradesco/index.ts,NaN,0
superbowleto,249,1,2,modified,2,0,README.md,low,0
superbowleto,248,1,15,modified,13,2,src/providers/bradesco/index.ts,NaN,0
superbowleto,247,1,14,modified,12,2,src/providers/bradesco/index.ts,NaN,0
superbowleto,246,1,3,modified,2,1,src/resources/boleto/schema.ts,NaN,0
superbowleto,245,2,2,modified,1,1,src/providers/bradesco/index.ts,NaN,0
superbowleto,245,2,2,modified,1,1,src/providers/bradesco/response-codes.ts,NaN,0
superbowleto,244,2,5,modified,4,1,src/providers/index.ts,NaN,0
superbowleto,244,2,16,modified,12,4,test/unit/providers/index.js,high,0
superbowleto,243,1,4,modified,2,2,docker-compose.yml,medium,0
superbowleto,242,1,50,modified,38,12,src/resources/boleto/model.ts,NaN,0
superbowleto,242,1,76,modified,75,1,test/unit/resources/boleto/model.js,high,0
superbowleto,241,3,2,modified,1,1,src/lib/errors/index.ts,NaN,0
superbowleto,241,3,81,modified,78,3,test/unit/lib/errors/index.js,high,0
superbowleto,240,0,2,modified,1,1,src/lib/errors/index.ts,NaN,1
superbowleto,240,0,81,modified,78,3,test/unit/lib/errors/index.js,high,1
superbowleto,239,1,7,modified,6,1,src/providers/bradesco/index.ts,NaN,0
superbowleto,237,2,12,added,12,0,src/database/migrations/20170807000001-add-payer-address-to-boleto.js,high,0
superbowleto,237,2,24,modified,15,9,src/providers/bradesco/index.ts,NaN,0
superbowleto,237,2,58,modified,55,3,src/resources/boleto/model.ts,NaN,0
superbowleto,237,2,37,modified,37,0,src/resources/boleto/schema.ts,NaN,0
superbowleto,237,2,9,modified,9,0,test/functional/boleto/index.js,high,0
superbowleto,237,2,8,modified,8,0,test/helpers/boleto/index.js,high,0
superbowleto,237,2,16,modified,16,0,test/unit/resources/boleto/model.js,high,0
superbowleto,235,1,11,modified,6,5,src/resources/boleto/index.ts,NaN,0
superbowleto,234,1,2,modified,1,1,README.md,low,1
superbowleto,233,1,6,modified,3,3,.github/PULL_REQUEST_TEMPLATE.md,low,0
superbowleto,232,1,9418,added,9418,0,package-lock.json,medium,1
superbowleto,232,1,6,modified,5,1,package.json,medium,1
superbowleto,232,1,13,modified,8,5,src/lib/credentials/index.ts,NaN,0
superbowleto,232,1,2,modified,1,1,src/lib/errors/index.ts,NaN,1
superbowleto,232,1,2,modified,1,1,src/lib/errors/normalizer.ts,NaN,0
superbowleto,232,1,10,modified,8,2,src/providers/bradesco/index.ts,NaN,0
superbowleto,232,1,58,modified,43,15,src/resources/boleto/index.ts,NaN,0
superbowleto,232,1,1,modified,1,0,src/resources/boleto/model.ts,NaN,0
superbowleto,232,1,2,modified,0,2,src/resources/boleto/service.ts,NaN,1
superbowleto,232,1,13,added,13,0,tslint.json,medium,0
superbowleto,231,1,2,modified,2,0,.travis.yml,medium,1
superbowleto,231,1,2,modified,2,0,README.md,low,2
superbowleto,231,1,2,modified,2,0,package.json,medium,2
superbowleto,231,1,87,modified,76,11,yarn.lock,NaN,1
superbowleto,230,1,1,modified,1,0,package.json,medium,2
superbowleto,230,1,4,modified,2,2,src/providers/bradesco/formatter.ts,NaN,0
superbowleto,230,1,11,modified,9,2,test/unit/providers/bradesco/formatter.js,high,0
superbowleto,230,1,12,modified,6,6,yarn.lock,NaN,1
superbowleto,229,1,12,added,12,0,src/database/migrations/20170802000001-add-digitable-line-to-boleto.js,high,0
superbowleto,229,1,22,modified,17,5,src/resources/boleto/model.ts,NaN,0
superbowleto,229,1,7,modified,4,3,test/unit/resources/boleto/model.js,high,0
superbowleto,228,1,1,modified,1,0,src/resources/boleto/schema.ts,NaN,0
superbowleto,227,1,17,added,17,0,src/database/migrations/20170801000001-change-company-name-boleto.js,high,0
superbowleto,227,1,17,added,17,0,src/database/migrations/20170801000002-change-company-document-number-boleto.js,high,0
superbowleto,227,1,4,modified,2,2,src/resources/boleto/model.ts,NaN,0
superbowleto,227,1,6,modified,4,2,src/resources/boleto/schema.ts,NaN,0
superbowleto,227,1,8,modified,0,8,test/functional/boleto/create.js,high,0
superbowleto,226,1,12,modified,7,5,src/resources/boleto/schema.ts,NaN,0
superbowleto,225,1,5,modified,2,3,src/resources/boleto/index.ts,NaN,0
superbowleto,221,1,21,modified,18,3,src/resources/boleto/model.ts,NaN,0
superbowleto,221,1,12,modified,12,0,src/resources/boleto/schema.ts,NaN,0
superbowleto,221,1,3,modified,3,0,test/functional/boleto/create.js,high,0
superbowleto,221,1,15,modified,2,13,test/functional/boleto/register/pending.js,high,0
superbowleto,221,1,13,modified,1,12,test/functional/boleto/register/refused.js,high,0
superbowleto,221,1,16,modified,1,15,test/functional/boleto/register/registered.js,high,0
superbowleto,221,1,3,modified,3,0,test/helpers/boleto/index.js,high,0
superbowleto,221,1,11,modified,10,1,test/unit/resources/boleto/model.js,high,0
superbowleto,220,1,2,modified,1,1,src/providers/bradesco/index.ts,NaN,0
superbowleto,220,1,2,modified,1,1,test/unit/providers/bradesco/index.js,high,0
superbowleto,219,1,12,modified,11,1,src/resources/boleto/service.ts,NaN,1
superbowleto,218,1,4,modified,2,2,src/providers/development/index.ts,NaN,0
superbowleto,218,1,2,modified,1,1,test/functional/boleto/create/development/pending.js,high,0
superbowleto,218,1,2,modified,1,1,test/functional/boleto/create/development/refused.js,high,0
superbowleto,218,1,2,modified,1,1,test/functional/boleto/create/development/registered.js,high,0
superbowleto,217,3,12,modified,6,6,src/config/lambda.ts,NaN,0
superbowleto,217,3,9,modified,6,3,src/config/sqs.ts,NaN,0
superbowleto,217,3,3,modified,2,1,src/lib/lambda/index.ts,NaN,0
superbowleto,217,3,3,modified,2,1,src/lib/sqs/index.ts,NaN,0
superbowleto,217,3,10,modified,6,4,src/resources/boleto/index.ts,NaN,0
superbowleto,217,3,8,modified,4,4,src/resources/boleto/lambda.ts,NaN,0
superbowleto,216,1,10,modified,8,2,src/resources/boleto/index.ts,NaN,0
superbowleto,215,1,4,modified,2,2,src/config/lambda.ts,NaN,0
superbowleto,215,1,4,modified,2,2,src/config/sqs.ts,NaN,0
superbowleto,215,1,3,modified,2,1,src/resources/boleto/index.ts,NaN,0
superbowleto,214,1,10,modified,2,8,src/providers/bradesco/index.ts,NaN,0
superbowleto,214,1,30,added,30,0,src/providers/development/index.ts,NaN,0
superbowleto,214,1,2,modified,2,0,src/providers/index.ts,NaN,0
superbowleto,214,1,9,modified,7,2,src/resources/boleto/model.ts,NaN,0
superbowleto,214,1,19,renamed,10,9,test/functional/boleto/create/bradesco/pending.js,high,0
superbowleto,214,1,12,renamed,7,5,test/functional/boleto/create/bradesco/refused.js,high,0
superbowleto,214,1,11,renamed,6,5,test/functional/boleto/create/bradesco/registered.js,high,0
superbowleto,214,1,41,added,41,0,test/functional/boleto/create/development/pending.js,high,0
superbowleto,214,1,41,added,41,0,test/functional/boleto/create/development/refused.js,high,0
superbowleto,214,1,41,added,41,0,test/functional/boleto/create/development/registered.js,high,0
superbowleto,212,3,13,modified,12,1,src/functions/database/index.ts,NaN,0
superbowleto,212,3,9,modified,9,0,src/lib/credentials/index.ts,NaN,0
superbowleto,212,3,6,modified,3,3,src/providers/bradesco/index.ts,NaN,0
superbowleto,210,1,2,modified,1,1,README.md,low,2
superbowleto,209,5,9236,added,9236,0,package-lock.json,medium,2
superbowleto,209,5,6,modified,5,1,package.json,medium,3
superbowleto,209,5,8,modified,4,4,src/config/database.ts,NaN,1
superbowleto,209,5,1,modified,0,1,src/config/queues.ts,NaN,1
superbowleto,209,5,4,modified,2,2,src/database/index.ts,NaN,1
superbowleto,209,5,8,modified,4,4,src/functions/database/index.ts,NaN,1
superbowleto,209,5,18,modified,10,8,src/lib/credentials/index.ts,NaN,1
superbowleto,209,5,6,modified,3,3,src/lib/errors/database.ts,NaN,1
superbowleto,209,5,11,modified,6,5,src/lib/errors/index.ts,NaN,2
superbowleto,209,5,6,modified,3,3,src/lib/errors/normalizer.ts,NaN,1
superbowleto,209,5,8,modified,4,4,src/lib/http/request.ts,NaN,1
superbowleto,209,5,2,modified,1,1,src/lib/http/response.ts,NaN,1
superbowleto,209,5,2,modified,1,1,src/lib/lambda/index.ts,NaN,1
superbowleto,209,5,2,modified,1,1,src/lib/sqs/index.ts,NaN,1
superbowleto,209,5,17,modified,11,6,src/providers/bradesco/index.ts,NaN,1
superbowleto,209,5,1,modified,0,1,src/providers/index.ts,NaN,1
superbowleto,209,5,99,modified,67,32,src/resources/boleto/index.ts,NaN,1
superbowleto,209,5,2,modified,1,1,src/resources/boleto/lambda.ts,NaN,1
superbowleto,209,5,4,modified,3,1,src/resources/boleto/model.ts,NaN,1
superbowleto,209,5,4,modified,2,2,src/resources/boleto/queues.ts,NaN,1
superbowleto,209,5,36,modified,26,10,src/resources/boleto/schema.ts,NaN,1
superbowleto,209,5,26,modified,13,13,src/resources/boleto/service.ts,NaN,2
superbowleto,209,5,12,added,12,0,tslint.json,medium,1
superbowleto,206,2,49,modified,38,11,src/providers/bradesco/index.ts,NaN,2
superbowleto,206,2,53,modified,43,10,test/functional/boleto/register/pending.js,high,1
superbowleto,205,1,21,added,21,0,LICENSE,low,0
superbowleto,203,1,4,modified,3,1,src/config/providers.ts,NaN,0
superbowleto,203,1,4,modified,4,0,src/providers/bradesco/index.ts,NaN,2
superbowleto,202,1,19,removed,0,19,infrastructure/access-control/lambda-role.tf,NaN,0
superbowleto,202,1,30,removed,0,30,infrastructure/access-control/logs-policies.tf,NaN,0
superbowleto,202,1,7,removed,0,7,infrastructure/access-control/outputs.tf,NaN,0
superbowleto,202,1,8,removed,0,8,infrastructure/access-control/secret-policies.tf,NaN,0
superbowleto,202,1,7,removed,0,7,infrastructure/access-control/variables.tf,NaN,0
superbowleto,202,1,30,removed,0,30,infrastructure/access-control/vpc-policies.tf,NaN,0
superbowleto,202,1,16,removed,0,16,infrastructure/application/database/credstash-database-auth.sh,high,0
superbowleto,202,1,36,removed,0,36,infrastructure/application/database/main.tf,NaN,0
superbowleto,202,1,13,removed,0,13,infrastructure/application/database/outputs.tf,NaN,0
superbowleto,202,1,15,removed,0,15,infrastructure/application/database/variables.tf,NaN,0
superbowleto,202,1,24,removed,0,24,infrastructure/application/functions/api-endpoint/main.tf,NaN,0
superbowleto,202,1,35,removed,0,35,infrastructure/application/functions/api-endpoint/variables.tf,NaN,0
superbowleto,202,1,49,removed,0,49,infrastructure/application/functions/api.tf,NaN,0
superbowleto,202,1,64,removed,0,64,infrastructure/application/functions/events.tf,NaN,0
superbowleto,202,1,0,removed,0,0,infrastructure/application/functions/lambda-function/lambda.zip,low,0
superbowleto,202,1,23,removed,0,23,infrastructure/application/functions/lambda-function/main.tf,NaN,0
superbowleto,202,1,11,removed,0,11,infrastructure/application/functions/lambda-function/outputs.tf,NaN,0
superbowleto,202,1,42,removed,0,42,infrastructure/application/functions/lambda-function/variables.tf,NaN,0
superbowleto,202,1,96,removed,0,96,infrastructure/application/functions/main.tf,NaN,0
superbowleto,202,1,18,removed,0,18,infrastructure/application/functions/schedule-event/main.tf,NaN,0
superbowleto,202,1,15,removed,0,15,infrastructure/application/functions/schedule-event/variables.tf,NaN,0
superbowleto,202,1,39,removed,0,39,infrastructure/application/functions/variables.tf,NaN,0
superbowleto,202,1,33,removed,0,33,infrastructure/application/main.tf,NaN,0
superbowleto,202,1,31,removed,0,31,infrastructure/application/sqs/iam.tf,NaN,0
superbowleto,202,1,7,removed,0,7,infrastructure/application/sqs/main.tf,NaN,0
superbowleto,202,1,3,removed,0,3,infrastructure/application/sqs/outputs.tf,NaN,0
superbowleto,202,1,15,removed,0,15,infrastructure/application/sqs/variables.tf,NaN,0
superbowleto,202,1,34,removed,0,34,infrastructure/application/variables.tf,NaN,0
superbowleto,202,1,49,removed,0,49,infrastructure/main.tf,NaN,0
superbowleto,202,1,94,removed,0,94,infrastructure/management/credstash.tf,NaN,0
superbowleto,201,1,12,modified,3,9,src/config/providers.ts,NaN,0
superbowleto,201,1,127,modified,70,57,src/providers/bradesco/index.ts,NaN,2
superbowleto,201,1,6,modified,3,3,test/unit/providers/bradesco/index.js,high,0
superbowleto,200,1,8,modified,4,4,src/lib/credentials/index.ts,NaN,1
superbowleto,199,2,120,modified,67,53,src/providers/bradesco/index.ts,NaN,3
superbowleto,199,2,2,modified,1,1,test/integration/providers/bradesco/index.js,high,1
superbowleto,199,2,8,modified,5,3,test/unit/providers/bradesco/index.js,high,1
superbowleto,198,1,41,modified,21,20,src/database/index.ts,NaN,1
superbowleto,198,1,27,modified,17,10,src/lib/credentials/index.ts,NaN,1
superbowleto,197,1,4,modified,4,0,src/resources/boleto/schema.ts,NaN,1
superbowleto,197,1,2,modified,2,0,test/functional/boleto/create.js,high,0
superbowleto,196,1,3,modified,3,0,src/resources/boleto/schema.ts,NaN,1
superbowleto,196,1,2,modified,2,0,test/functional/boleto/create.js,high,0
superbowleto,195,2,1,modified,1,0,.travis.yml,medium,1
superbowleto,195,2,16,modified,16,0,src/providers/bradesco/response-codes.ts,NaN,0
superbowleto,194,1,2,modified,1,1,src/config/queues.ts,NaN,1
superbowleto,193,1,2,modified,1,1,src/resources/boleto/index.ts,NaN,1
superbowleto,192,1,17,modified,17,0,src/resources/boleto/index.ts,NaN,1
superbowleto,191,1,2,modified,1,1,infrastructure/application/database/outputs.tf,NaN,0
superbowleto,190,1,5,modified,1,4,infrastructure/application/functions/lambda-function/main.tf,NaN,0
superbowleto,189,1,18,modified,18,0,infrastructure/network/security-groups.tf,NaN,0
superbowleto,186,1,2,modified,1,1,package.json,medium,3
superbowleto,186,1,10,modified,8,2,yarn.lock,NaN,1
superbowleto,184,1,4,modified,2,2,src/lib/credentials/index.ts,NaN,1
superbowleto,182,1,1,modified,1,0,infrastructure/access-control/logs-policies.tf,NaN,0
superbowleto,181,1,6,modified,2,4,webpackfile.js,high,0
superbowleto,179,2,6,modified,6,0,infrastructure/application/database/outputs.tf,NaN,0
superbowleto,179,2,1,modified,1,0,infrastructure/application/functions/main.tf,NaN,0
superbowleto,179,2,4,modified,4,0,infrastructure/application/functions/variables.tf,NaN,0
superbowleto,179,2,1,modified,1,0,infrastructure/application/main.tf,NaN,0
superbowleto,179,2,6,modified,3,3,src/config/database.ts,NaN,1
android,47,3,7,modified,5,2,.travis.yml,medium,0
android,47,3,7,modified,4,3,app/build.gradle,NaN,0
android,47,3,2,modified,1,1,app/src/main/kotlin/com/elifut/services/GoogleApiGameRoomHandler.kt,NaN,0
android,47,3,26,modified,13,13,build.gradle,NaN,0
android,47,3,2,modified,0,2,gradle.properties,NaN,0
android,47,3,2,modified,1,1,gradle/wrapper/gradle-wrapper.properties,NaN,0
android,46,2,1,modified,1,0,app/build.gradle,NaN,0
android,46,2,69,modified,46,23,app/src/androidTest/assets/tapes/LeagueTest/test_league.yaml,medium,0
android,46,2,2,modified,1,1,app/src/androidTest/kotlin/com.elifut/LeagueTest.kt,NaN,0
android,46,2,6,modified,6,0,app/src/main/java/com/elifut/NetworkModule.java,high,0
android,46,2,33,modified,19,14,app/src/main/java/com/elifut/activity/MatchProgressActivity.java,high,0
android,46,2,14,modified,5,9,app/src/main/java/com/elifut/models/MatchResult.java,high,0
android,46,2,10,added,10,0,app/src/main/kotlin/com/elifut/widget/CoordinatorAwareLinearLayout.kt,NaN,0
android,46,2,18,added,18,0,app/src/main/kotlin/com/elifut/widget/MoveUpBehavior.kt,NaN,0
android,46,2,36,modified,18,18,app/src/main/res/layout/activity_match_progress.xml,medium,0
android,45,2,38,modified,38,0,app/src/main/java/com/elifut/activity/MatchProgressActivity.java,high,0
android,45,2,0,added,0,0,app/src/main/res/drawable-xhdpi/ic_backward_white_48dp.png,low,0
android,45,2,0,added,0,0,app/src/main/res/drawable-xxhdpi/ic_backward_white_48dp.png,low,0
android,45,2,0,added,0,0,app/src/main/res/drawable-xxxhdpi/ic_backward_white_48dp.png,low,0
android,45,2,39,modified,32,7,app/src/main/res/layout/activity_match_progress.xml,medium,0
android,43,3,2,modified,1,1,.travis.yml,medium,0
android,43,3,28,modified,26,2,app/build.gradle,NaN,0
android,43,3,1253,added,1253,0,app/src/androidTest/assets/tapes/LeagueTest/test_league.yaml,medium,0
android,43,3,89,added,89,0,app/src/androidTest/kotlin/com.elifut/LeagueTest.kt,NaN,0
android,43,3,10,added,10,0,app/src/debug/AndroidManifest.xml,medium,0
android,43,3,8,modified,7,1,app/src/main/java/com/elifut/ElifutComponent.java,high,0
android,43,3,14,modified,11,3,app/src/main/java/com/elifut/NetworkModule.java,high,0
android,43,3,8,modified,2,6,app/src/main/java/com/elifut/activity/MatchProgressActivity.java,high,0
android,43,3,15,modified,15,0,app/src/main/java/com/elifut/preferences/UserPreferences.java,high,0
android,43,3,9,added,9,0,app/src/main/kotlin/com/elifut/OkReplayInterceptorProvider.kt,NaN,0
android,43,3,5,modified,3,2,app/src/main/kotlin/com/elifut/services/LeagueRoundGenerator.kt,NaN,0
android,43,3,12,modified,8,4,build.gradle,NaN,0
android,43,3,4,modified,2,2,gradle/wrapper/gradle-wrapper.properties,NaN,0
android,41,1,4,modified,3,1,app/src/main/java/com/elifut/models/Club.java,high,0
android,38,1,4,modified,2,2,app/build.gradle,NaN,0
android,38,1,4,modified,3,1,app/src/main/java/com/elifut/ElifutApplication.java,high,0
android,38,1,16,modified,16,0,app/src/main/java/com/elifut/Util.java,high,0
android,38,1,45,modified,26,19,app/src/main/java/com/elifut/activity/NavigationActivity.java,high,0
android,38,1,30,modified,11,19,app/src/main/java/com/elifut/fragment/LeagueProgressFragment.java,high,0
android,38,1,16,modified,10,6,app/src/main/java/com/elifut/preferences/LeagueDetails.java,high,0
android,38,1,6,modified,1,5,app/src/main/java/com/elifut/util/ColorUtils.java,high,0
android,38,1,23,added,23,0,app/src/main/kotlin/com/elifut/util/ColorUtils.kt,NaN,0
android,38,1,1,modified,1,0,app/src/main/res/values/strings.xml,medium,0
android,35,4,17,modified,13,4,app/src/main/java/com/elifut/AppInitializer.java,high,0
android,35,4,7,modified,0,7,app/src/main/java/com/elifut/DataModule.java,high,0
android,35,4,12,modified,11,1,app/src/main/java/com/elifut/activity/MainActivity.java,high,0
android,35,4,2,modified,1,1,app/src/main/java/com/elifut/activity/MatchProgressActivity.java,high,0
android,35,4,6,modified,3,3,app/src/main/java/com/elifut/services/ElifutDataStore.java,high,0
android,35,4,4,modified,1,3,app/src/main/kotlin/com/elifut/util/CollectionUtils.kt,NaN,0
android,32,5,8,modified,4,4,app/build.gradle,NaN,0
android,32,5,8,modified,4,4,build.gradle,NaN,0
android,32,5,4,modified,2,2,gradle/wrapper/gradle-wrapper.properties,NaN,0
android,31,3,2,modified,1,1,.travis.yml,medium,0
android,31,3,111,modified,60,51,app/build.gradle,NaN,0
android,31,3,33,modified,18,15,build.gradle,NaN,0
android,31,3,4,modified,3,1,gradle.properties,NaN,0
android,30,12,2,modified,1,1,.gitignore,low,0
android,30,12,4,modified,2,2,.travis.yml,medium,0
android,30,12,2,modified,1,1,README.md,low,0
android,30,12,37,modified,17,20,app/build.gradle,NaN,0
android,30,12,0,renamed,0,0,app/src/debug/google-services.json,medium,0
android,30,12,28,modified,19,9,app/src/main/AndroidManifest.xml,medium,0
android,30,12,77,added,77,0,app/src/main/kotlin/com/felipecsl/elifut/activity/OnlineFriendlyActivity.kt,NaN,0
android,30,12,9,added,9,0,app/src/main/kotlin/com/felipecsl/elifut/models/GoogleApiConnectionResult.kt,NaN,0
android,30,12,107,added,107,0,app/src/main/kotlin/com/felipecsl/elifut/services/GoogleApiConnectionHandler.kt,NaN,0
android,30,12,257,added,257,0,app/src/main/kotlin/com/felipecsl/elifut/services/GoogleApiGameRoomHandler.kt,NaN,0
android,27,3,0,added,0,0,app/src/main/ic_launcher-web.png,low,0
android,27,3,0,modified,0,0,app/src/main/res/mipmap-hdpi/ic_launcher.png,low,0
android,27,3,0,modified,0,0,app/src/main/res/mipmap-mdpi/ic_launcher.png,low,0
android,27,3,0,modified,0,0,app/src/main/res/mipmap-xhdpi/ic_launcher.png,low,0
android,27,3,0,modified,0,0,app/src/main/res/mipmap-xxhdpi/ic_launcher.png,low,0
android,27,3,0,modified,0,0,app/src/main/res/mipmap-xxxhdpi/ic_launcher.png,low,0
android,27,3,0,added,0,0,feature-graphic.psb,NaN,0
android,27,3,0,added,0,0,icon.png,low,0
android,27,3,0,modified,0,0,icon.psb,NaN,0
android,26,2,4,modified,2,2,app/build.gradle,NaN,0
android,26,2,4,modified,2,2,build.gradle,NaN,0
android,25,1,5,modified,3,2,app/build.gradle,NaN,0
android,25,1,13,added,13,0,app/src/debug/java/com/felipecsl/elifut/MultiDex.java,high,0
android,25,1,12,modified,10,2,app/src/main/java/com/felipecsl/elifut/ElifutApplication.java,high,0
android,25,1,13,added,13,0,app/src/release/java/com/felipecsl/elifut/MultiDex.java,high,0
android,25,1,19,added,19,0,app/src/test/java/com/felipecsl/elifut/MultiDexClassTest.java,high,0
android,24,1,4,modified,2,2,app/src/test/java/com/felipecsl/elifut/ElifutTestRunner.java,high,0
android,23,1,25,modified,13,12,app/build.gradle,NaN,0
android,23,1,12,added,12,0,app/src/main/java/com/felipecsl/elifut/AutoValueMoshiAdapterFactory.java,high,0
android,23,1,3,modified,1,2,app/src/main/java/com/felipecsl/elifut/DataModule.java,high,0
android,23,1,3,modified,1,2,app/src/test/java/com/felipecsl/elifut/ModelListAdapterTest.java,high,0
android,23,1,10,modified,6,4,build.gradle,NaN,0
android,23,1,0,added,0,0,icon.psb,NaN,0
android,22,4,2,modified,1,1,.gitignore,low,0
android,22,4,4,modified,2,2,.travis.yml,medium,0
android,22,4,6,modified,3,3,app/build.gradle,NaN,0
android,22,4,25,modified,9,16,app/google-services.json,medium,0
android,22,4,7,modified,3,4,app/src/main/java/com/felipecsl/elifut/fragment/LeagueProgressFragment.java,high,0
android,22,4,0,modified,0,0,app/src/main/res/mipmap-hdpi/ic_launcher.png,low,0
android,22,4,0,modified,0,0,app/src/main/res/mipmap-mdpi/ic_launcher.png,low,0
android,22,4,0,modified,0,0,app/src/main/res/mipmap-xhdpi/ic_launcher.png,low,0
android,22,4,0,modified,0,0,app/src/main/res/mipmap-xxhdpi/ic_launcher.png,low,0
android,22,4,0,added,0,0,app/src/main/res/mipmap-xxxhdpi/ic_launcher.png,low,0
android,22,4,1,modified,1,0,app/src/main/res/values/strings.xml,medium,0
android,22,4,14,modified,7,7,build.gradle,NaN,0
android,22,4,2,modified,1,1,gradle.properties,NaN,0
android,22,4,4,modified,2,2,gradle/wrapper/gradle-wrapper.properties,NaN,0
android,18,3,12,modified,6,6,app/build.gradle,NaN,0
android,18,3,9,modified,5,4,build.gradle,NaN,0
android,17,1,8,modified,4,4,app/build.gradle,NaN,0
android,17,1,7,modified,5,2,build.gradle,NaN,0
android,16,2,9,modified,5,4,app/build.gradle,NaN,0
android,16,2,127,modified,71,56,app/src/main/java/com/felipecsl/elifut/activitiy/MatchProgressActivity.java,high,0
android,16,2,2,modified,1,1,app/src/main/java/com/felipecsl/elifut/fragment/LeagueProgressFragment.java,high,0
android,16,2,5,added,5,0,app/src/main/res/drawable/match_event_background.xml,medium,0
android,16,2,201,modified,119,82,app/src/main/res/layout/content_match_progress.xml,medium,0
android,16,2,24,modified,17,7,app/src/main/res/layout/match_event.xml,medium,0
android,16,2,5,modified,4,1,app/src/main/res/values/strings.xml,medium,0
android,15,5,27,modified,15,12,app/build.gradle,NaN,0
android,15,5,3,modified,1,2,app/proguard-rules.pro,NaN,0
android,15,5,2,modified,1,1,app/src/main/AndroidManifest.xml,medium,0
android,15,5,20,removed,0,20,app/src/main/kotlin/com/felipecsl/elifut/ElifutApplication.kt,NaN,0
android,15,5,11,modified,5,6,app/src/main/kotlin/com/felipecsl/elifut/util/CollectionUtils.kt,NaN,0
android,15,5,66,modified,41,25,app/src/main/res/layout/content_match_progress.xml,medium,0
android,15,5,13,added,13,0,app/src/test/java/com/felipecsl/elifut/TestElifutApplication.java,high,0
android,15,5,13,removed,0,13,app/src/test/java/com/felipecsl/elifut/TestElifutApplication.kt,NaN,0
android,15,5,2,modified,0,2,app/src/test/java/com/felipecsl/elifut/match/LeagueRoundExecutorTest.java,high,0
android,15,5,39,added,39,0,app/src/test/java/com/felipecsl/elifut/models/GoalGeneratorTest.java,high,0
android,15,5,32,removed,0,32,app/src/test/kotlin/com/felipecsl/elifut/models/GoalGeneratorTest.kt,NaN,0
android,14,2,2,modified,1,1,.travis.yml,medium,0
android,14,2,16,modified,9,7,app/build.gradle,NaN,0
android,14,2,9,modified,5,4,app/src/main/java/com/felipecsl/elifut/services/ClubSquadBuilder.java,high,0
android,14,2,70,added,70,0,app/src/main/kotlin/com/felipecsl/elifut/match/MatchResultGenerator.kt,NaN,0
android,14,2,27,added,27,0,app/src/main/kotlin/com/felipecsl/elifut/models/GoalGenerator.kt,NaN,0
android,14,2,26,added,26,0,app/src/main/kotlin/com/felipecsl/elifut/models/Players.kt,NaN,0
android,14,2,24,modified,13,11,app/src/main/kotlin/com/felipecsl/elifut/util/CollectionUtils.kt,NaN,0
android,14,2,17,modified,15,2,app/src/test/java/com/felipecsl/elifut/MatchResultGeneratorTest.java,high,0
android,14,2,5,modified,3,2,app/src/test/java/com/felipecsl/elifut/ModelListAdapterTest.java,high,0
android,14,2,1,modified,1,0,app/src/test/java/com/felipecsl/elifut/TestElifutGraph.java,high,0
android,14,2,13,modified,13,0,app/src/test/java/com/felipecsl/elifut/TestFixtures.java,high,0
android,14,2,10,modified,5,5,app/src/test/java/com/felipecsl/elifut/match/LeagueRoundExecutorTest.java,high,0
android,14,2,3,modified,2,1,app/src/test/java/com/felipecsl/elifut/models/MatchResultTest.java,high,0
android,14,2,3,modified,2,1,app/src/test/java/com/felipecsl/elifut/models/converter/LeagueRoundConverterTest.java,high,0
android,14,2,3,modified,2,1,app/src/test/java/com/felipecsl/elifut/models/converter/MatchConverterTest.java,high,0
android,13,2,20,modified,13,7,app/build.gradle,NaN,0
android,13,2,8,modified,6,2,app/proguard-rules.pro,NaN,0
android,13,2,2,modified,1,1,app/src/main/AndroidManifest.xml,medium,0
android,13,2,20,removed,0,20,app/src/main/java/com/felipecsl/elifut/ElifutApplication.java,high,0
android,13,2,4,modified,2,2,app/src/main/java/com/felipecsl/elifut/activitiy/MatchProgressActivity.java,high,0
android,13,2,6,modified,3,3,app/src/main/java/com/felipecsl/elifut/adapter/ClubsAdapter.java,high,0
android,13,2,4,modified,2,2,app/src/main/java/com/felipecsl/elifut/preferences/LeagueDetails.java,high,0
android,13,2,84,removed,0,84,app/src/main/java/com/felipecsl/elifut/services/LeagueRoundGenerator.java,high,0
android,13,2,26,removed,0,26,app/src/main/java/com/felipecsl/elifut/util/CollectionUtils.java,high,0
android,13,2,20,added,20,0,app/src/main/kotlin/com/felipecsl/elifut/ElifutApplication.kt,NaN,0
android,13,2,75,added,75,0,app/src/main/kotlin/com/felipecsl/elifut/services/LeagueRoundGenerator.kt,NaN,0
android,13,2,18,added,18,0,app/src/main/kotlin/com/felipecsl/elifut/util/CollectionUtils.kt,NaN,0
android,13,2,0,renamed,0,0,app/src/release/java/com/felipecsl/elifut/StethoInitializer.java,high,0
android,13,2,13,removed,0,13,app/src/test/java/com/felipecsl/elifut/TestElifutApplication.java,high,0
android,13,2,13,added,13,0,app/src/test/java/com/felipecsl/elifut/TestElifutApplication.kt,NaN,0
android,13,2,2,modified,2,0,build.gradle,NaN,0
android,13,2,3,modified,2,1,gradle.properties,NaN,0
android,12,2,23,modified,17,6,app/src/main/java/com/felipecsl/elifut/activitiy/MatchProgressActivity.java,high,0
android,12,2,9,added,9,0,app/src/main/res/drawable/ic_attach_money_black_24dp.xml,medium,0
android,12,2,6,modified,3,3,build.gradle,NaN,0
android,11,1,43,modified,33,10,app/src/main/java/com/felipecsl/elifut/activitiy/MatchProgressActivity.java,high,0
android,11,1,0,added,0,0,app/src/main/res/drawable-xhdpi/ball.png,low,0
android,11,1,0,added,0,0,app/src/main/res/drawable-xxhdpi/ball.png,low,0
android,11,1,0,added,0,0,app/src/main/res/drawable-xxxhdpi/ball.png,low,0
android,11,1,4,added,4,0,app/src/main/res/drawable/ic_mood_black_48px.xml,medium,0
android,11,1,5,added,5,0,app/src/main/res/drawable/ic_schedule_black_48px.xml,medium,0
android,11,1,7,added,7,0,app/src/main/res/drawable/ic_sentiment_neutral_black_48px.xml,medium,0
android,11,1,4,added,4,0,app/src/main/res/drawable/ic_sentiment_very_dissatisfied_black_48px.xml,medium,0
android,11,1,45,modified,27,18,app/src/main/res/layout/content_match_progress.xml,medium,0
android,11,1,9,added,9,0,app/src/main/res/layout/match_event.xml,medium,0
android,11,1,2,modified,2,0,app/src/main/res/values/dimens.xml,medium,0
android,11,1,2,modified,1,1,build.gradle,NaN,0
android,10,1,2,modified,2,0,app/src/main/java/com/felipecsl/elifut/activitiy/MainActivity.java,high,0
android,10,1,45,modified,33,12,app/src/main/java/com/felipecsl/elifut/activitiy/NavigationActivity.java,high,0
android,10,1,4,modified,3,1,app/src/main/java/com/felipecsl/elifut/adapter/CountriesSpinnerAdapter.java,high,0
android,10,1,4,modified,4,0,app/src/main/java/com/felipecsl/elifut/match/MatchResultController.java,high,0
android,10,1,18,modified,17,1,app/src/main/java/com/felipecsl/elifut/preferences/UserPreferences.java,high,0
android,10,1,9,added,9,0,app/src/main/res/drawable/ic_attach_money_white_24px.xml,medium,0
android,10,1,25,modified,21,4,app/src/main/res/layout/nav_header_home.xml,medium,0
android,10,1,1,modified,1,0,app/src/main/res/layout/navigation_view.xml,medium,0
android,10,1,54,modified,52,2,app/src/test/java/com/felipecsl/elifut/MatchResultControllerTest.java,high,0
android,9,4,6,modified,5,1,.travis.yml,medium,0
android,9,4,12,modified,8,4,README.md,low,0
android,9,4,7,modified,6,1,app/build.gradle,NaN,0
android,9,4,4,modified,3,1,app/src/main/AndroidManifest.xml,medium,0
android,9,4,3,modified,3,0,app/src/main/java/com/felipecsl/elifut/ElifutApplication.java,high,0
android,9,4,14,modified,7,7,build.gradle,NaN,0
android,8,3,1,modified,1,0,.gitignore,low,0
android,8,3,12,modified,10,2,README.md,low,0
android,8,3,6,modified,4,2,app/build.gradle,NaN,0
android,8,3,45,added,45,0,app/google-services.json,medium,0
android,8,3,13,modified,11,2,app/proguard-rules.pro,NaN,0
android,8,3,25,modified,13,12,app/src/main/AndroidManifest.xml,medium,0
android,3,1,57,modified,37,20,app/src/main/res/layout/fragment_team_squad.xml,medium,0
android,3,1,10,modified,10,0,app/src/test/java/com/felipecsl/elifut/models/converter/MatchConverterTest.java,high,0
android,3,1,24,modified,22,2,app/src/test/java/com/felipecsl/elifut/preferences/LeagueDetailsTest.java,high,0
android,3,1,20,modified,6,14,app/src/test/java/com/felipecsl/elifut/services/LeagueRoundGeneratorTest.java,high,0
android,3,1,2,modified,1,1,build.gradle,NaN,0
android,1,1,1,modified,1,0,app/build.gradle,NaN,0
android,1,1,56,added,56,0,app/coverage.gradle,NaN,0
FantasyPlus,16,1,79,modified,41,38,chrome/contentscript.js,high,0
FantasyPlus,16,1,4,modified,2,2,chrome/manifest.json,medium,0
FantasyPlus,16,1,79,modified,41,38,firefox/contentscript.js,high,0
FantasyPlus,16,1,4,modified,2,2,firefox/package.json,medium,0
FantasyPlus,15,1,10,modified,1,9,chrome/contentscript.js,high,1
FantasyPlus,15,1,2,modified,1,1,chrome/manifest.json,medium,1
FantasyPlus,15,1,12,modified,2,10,firefox/contentscript.js,high,1
FantasyPlus,15,1,2,modified,1,1,firefox/package.json,medium,1
FantasyPlus,10,1,10,modified,10,0,app/contentscript.js,high,1
FantasyPlus,5,0,619,modified,332,287,app/contentscript.js,high,2
FantasyPlus,5,0,0,added,0,0,app/loading.gif,NaN,1
FantasyPlus,5,0,3,modified,3,0,app/manifest.json,medium,1
FantasyPlus,4,1,27,modified,23,4,app/contentscript.js,high,3
FantasyPlus,4,1,3,modified,2,1,app/manifest.json,medium,2
FantasyPlus,3,2,29,modified,24,5,app/contentscript.js,high,4
FantasyPlus,3,2,3,modified,2,1,app/manifest.json,medium,3
FantasyPlus,2,1,1,added,1,0,.gitignore,low,1
FantasyPlus,2,1,165,modified,76,89,app/contentscript.js,high,5
FantasyPlus,1,0,11,modified,9,2,app/contentscript.js,high,5
FantasyPlus,1,0,5,modified,3,2,app/manifest.json,medium,3
world-cup,46,1,3,modified,2,1,2018--russia/cup_finals.txt,low,0
world-cup,45,1,3,modified,2,1,2018--russia/cup_finals.txt,low,0
world-cup,44,1,6,modified,4,2,2018--russia/cup.txt,low,0
world-cup,43,1,8,modified,4,4,2018--russia/cup_finals.txt,low,0
world-cup,42,4,6,modified,4,2,2018--russia/cup.txt,low,0
world-cup,41,1,5,modified,3,2,2018--russia/cup_finals.txt,low,0
world-cup,40,1,13,modified,8,5,2018--russia/cup.txt,low,1
world-cup,39,1,14,modified,8,6,2018--russia/cup.txt,low,1
world-cup,38,1,8,modified,4,4,2018--russia/cup_finals.txt,low,0
world-cup,37,1,9,modified,6,3,2018--russia/cup.txt,low,2
world-cup,36,1,9,modified,6,3,2018--russia/cup.txt,low,2
world-cup,35,1,3,modified,2,1,2018--russia/cup.txt,low,2
world-cup,34,1,3,modified,2,1,2018--russia/cup.txt,low,2
world-cup,33,1,3,modified,2,1,2018--russia/cup.txt,low,2
world-cup,32,0,12210,added,12210,0,2018--russia/players.json,medium,1
world-cup,26,1,11,modified,8,3,2018--russia/cup.txt,low,2
world-cup,25,1,38,modified,19,19,2014--brazil/cup.txt,low,0
world-cup,25,1,10,modified,5,5,2014--brazil/cup_finals.txt,low,0
world-cup,24,1,0,renamed,0,0,1930--uruguay/group.txt,low,1
world-cup,24,1,0,renamed,0,0,1934--italy/group.txt,low,1
world-cup,24,1,0,renamed,0,0,1938--france/group.txt,low,1
world-cup,24,1,0,renamed,0,0,1950--brazil/group.txt,low,1
world-cup,24,1,0,renamed,0,0,1954--switzerland/group.txt,low,1
world-cup,24,1,0,renamed,0,0,1958--sweden/group.txt,low,1
world-cup,24,1,0,renamed,0,0,1962--chile/group.txt,low,1
world-cup,24,1,0,renamed,0,0,1966--england/group.txt,low,1
world-cup,24,1,0,renamed,0,0,1970--mexico/group.txt,low,1
world-cup,24,1,0,renamed,0,0,1974--west-germany/group.txt,low,1
world-cup,24,1,0,renamed,0,0,1978--argentina/group.txt,low,1
world-cup,24,1,0,renamed,0,0,1982--spain/group.txt,low,1
world-cup,24,1,4,modified,2,2,1986--mexico/cup.yml,medium,1
world-cup,24,1,0,renamed,0,0,1986--mexico/group.txt,low,1
world-cup,24,1,0,renamed,0,0,1986--mexico/knockout.txt,low,1
world-cup,24,1,4,modified,2,2,1990--italy/cup.yml,medium,1
world-cup,24,1,0,renamed,0,0,1990--italy/group.txt,low,1
world-cup,24,1,0,renamed,0,0,1990--italy/knockout.txt,low,1
world-cup,24,1,4,modified,2,2,1994--united-states/cup.yml,medium,1
world-cup,24,1,0,renamed,0,0,1994--united-states/group.txt,low,1
world-cup,24,1,0,renamed,0,0,1994--united-states/knockout.txt,low,1
world-cup,24,1,4,modified,2,2,1998--france/cup.yml,medium,1
world-cup,24,1,0,renamed,0,0,1998--france/group.txt,low,1
world-cup,24,1,0,renamed,0,0,1998--france/knockout.txt,low,1
world-cup,24,1,4,modified,2,2,2002--south-korea-n-japan/cup.yml,medium,1
world-cup,24,1,0,renamed,0,0,2002--south-korea-n-japan/group.txt,low,1
world-cup,24,1,0,renamed,0,0,2002--south-korea-n-japan/knockout.txt,low,1
world-cup,24,1,4,modified,2,2,2006--germany/cup.yml,medium,1
world-cup,24,1,0,renamed,0,0,2006--germany/group.txt,low,1
world-cup,24,1,0,renamed,0,0,2006--germany/knockout.txt,low,1
world-cup,20,1,6,modified,3,3,2014--brazil/cup.txt,low,1
world-cup,19,0,6,modified,3,3,2014--brazil/cup.txt,low,2
world-cup,18,1,6,modified,3,3,2014--brazil/cup.txt,low,2
world-cup,17,1,2,modified,1,1,2014--brazil/squads/co-colombia.txt,low,0
world-cup,16,1,5,modified,1,4,2014--brazil/squads/ar-argentina.txt,low,0
world-cup,15,0,19,modified,19,0,2014--brazil/squads/jp-japan.txt,low,0
world-cup,15,0,75,modified,47,28,2014--brazil/squads/wc_squad.php,NaN,0
world-cup,14,1,23,modified,21,2,2014--brazil/squads/en-england.txt,low,0
world-cup,13,0,49,modified,28,21,2014--brazil/squads/ar-argentina.txt,low,0
world-cup,13,0,53,modified,50,3,2014--brazil/squads/au-australia.txt,low,0
world-cup,13,0,54,modified,51,3,2014--brazil/squads/ba-bosnia-herzegovina.txt,low,0
world-cup,13,0,48,modified,45,3,2014--brazil/squads/be-belgium.txt,low,0
world-cup,13,0,53,modified,26,27,2014--brazil/squads/br-brazil.txt,low,0
world-cup,13,0,31,modified,29,2,2014--brazil/squads/ch-switzerland.txt,low,0
world-cup,13,0,67,modified,33,34,2014--brazil/squads/ci-cote-d-ivoire.txt,low,0
world-cup,13,0,50,modified,47,3,2014--brazil/squads/cl-chile.txt,low,0
world-cup,13,0,51,modified,48,3,2014--brazil/squads/cm-cameroon.txt,low,0
world-cup,13,0,65,modified,30,35,2014--brazil/squads/co-colombia.txt,low,0
world-cup,13,0,53,modified,50,3,2014--brazil/squads/cr-costa-rica.txt,low,0
world-cup,13,0,50,modified,47,3,2014--brazil/squads/de-deutschland.txt,low,0
world-cup,13,0,54,modified,51,3,2014--brazil/squads/dz-algeria.txt,low,0
world-cup,13,0,59,modified,33,26,2014--brazil/squads/ec-ecuador.txt,low,0
world-cup,13,0,27,modified,24,3,2014--brazil/squads/en-england.txt,low,0
world-cup,13,0,52,modified,49,3,2014--brazil/squads/es-espana.txt,low,0
world-cup,13,0,46,modified,43,3,2014--brazil/squads/fr-france.txt,low,0
world-cup,13,0,49,modified,46,3,2014--brazil/squads/gh-ghana.txt,low,0
world-cup,13,0,55,modified,27,28,2014--brazil/squads/gr-greece.txt,low,0
world-cup,13,0,46,modified,43,3,2014--brazil/squads/hn-honduras.txt,low,0
world-cup,13,0,52,modified,49,3,2014--brazil/squads/hr-croatia.txt,low,0
world-cup,13,0,53,modified,50,3,2014--brazil/squads/ir-iran.txt,low,0
world-cup,13,0,52,modified,49,3,2014--brazil/squads/it-italy.txt,low,0
world-cup,13,0,36,modified,8,28,2014--brazil/squads/jp-japan.txt,low,0
world-cup,13,0,46,modified,43,3,2014--brazil/squads/kr-south-korea.txt,low,0
world-cup,13,0,45,modified,44,1,2014--brazil/squads/mx-mexico.txt,low,0
world-cup,13,0,54,modified,51,3,2014--brazil/squads/ng-nigeria.txt,low,0
world-cup,13,0,53,modified,50,3,2014--brazil/squads/nl-netherlands.txt,low,0
world-cup,13,0,46,modified,43,3,2014--brazil/squads/pt-portugal.txt,low,0
world-cup,13,0,48,modified,45,3,2014--brazil/squads/ru-russia.txt,low,0
world-cup,12,0,49,modified,46,3,2014--brazil/squads/ci-cote-d-ivoire.txt,low,0
world-cup,12,0,53,modified,50,3,2014--brazil/squads/co-colombia.txt,low,0
world-cup,12,0,45,modified,42,3,2014--brazil/squads/gr-greece.txt,low,0
world-cup,12,0,45,modified,42,3,2014--brazil/squads/jp-japan.txt,low,0
world-cup,9,1,44,modified,41,3,2014--brazil/squads/br-brazil.txt,low,0
world-cup,7,0,16,modified,8,8,2014/cup.txt,low,0
world-cup,6,1,96,modified,48,48,2014/cup.txt,low,1
world-cup,5,1,96,modified,48,48,2014/cup.txt,low,1
world-cup,4,2,44,modified,41,3,2014/e_squad_ec_ecuador.txt,low,0
world-cup,4,2,40,modified,37,3,2014/f_squad_ar_argentina.txt,low,0
world-cup,3,2,4,modified,2,2,2014/quali_africa.txt,low,0
world-cup,2,1,2,modified,1,1,2014/quali_africa.txt,low,0
world-cup,1,3,43,added,43,0,2014/quali_africa.txt,low,0
awesome-football,2,0,2,modified,0,2,README.md,low,0
fantasy_football_nerd,10,4,5,modified,4,1,lib/fantasy_football_nerd.rb,high,0
fantasy_football_nerd,10,4,24,modified,24,0,spec/fantasy_football_nerd_spec.rb,high,0
fantasy_football_nerd,10,4,78,added,78,0,spec/vcr/cassettes/Fantasy_Football_Nerd_Gem/should_retrieve_weather_forecasts.yml,medium,0
fantasy_football_nerd,9,2,5,modified,4,1,Gemfile.lock,NaN,0
fantasy_football_nerd,9,2,71,modified,42,29,README.md,low,0
fantasy_football_nerd,9,2,10,modified,9,1,lib/fantasy_football_nerd.rb,high,0
fantasy_football_nerd,9,2,11,modified,10,1,spec/fantasy_football_nerd_spec.rb,high,0
fantasy_football_nerd,9,2,6,modified,3,3,spec/request_spec.rb,high,0
fantasy_football_nerd,9,2,54,modified,54,0,spec/vcr/cassettes/Fantasy_Football_Nerd_Commercial_Feeds/should_retrieve_Brady_s_player_stats.yml,medium,0
fantasy_football_nerd,9,2,54,modified,54,0,spec/vcr/cassettes/Fantasy_Football_Nerd_Commercial_Feeds/should_retrieve_Forte_s_player_stats.yml,medium,0
fantasy_football_nerd,9,2,54,modified,54,0,spec/vcr/cassettes/Fantasy_Football_Nerd_Commercial_Feeds/should_retrieve_player_information.yml,medium,0
fantasy_football_nerd,9,2,331,modified,331,0,spec/vcr/cassettes/Fantasy_Football_Nerd_Gem/should_retrieve_auction_values.yml,medium,0
fantasy_football_nerd,9,2,70,modified,70,0,spec/vcr/cassettes/Fantasy_Football_Nerd_Gem/should_retrieve_bye_weeks.yml,medium,0
fantasy_football_nerd,9,2,95,modified,95,0,spec/vcr/cassettes/Fantasy_Football_Nerd_Gem/should_retrieve_draft_projections.yml,medium,0
fantasy_football_nerd,9,2,844,modified,844,0,spec/vcr/cassettes/Fantasy_Football_Nerd_Gem/should_retrieve_injuries_with_a_week.yml,medium,0
fantasy_football_nerd,9,2,844,modified,844,0,spec/vcr/cassettes/Fantasy_Football_Nerd_Gem/should_retrieve_injuries_without_a_week.yml,medium,0
fantasy_football_nerd,9,2,1671,modified,1671,0,spec/vcr/cassettes/Fantasy_Football_Nerd_Gem/should_retrieve_players.yml,medium,0
fantasy_football_nerd,9,2,849,added,849,0,spec/vcr/cassettes/Fantasy_Football_Nerd_Gem/should_retrieve_position_tiers.yml,medium,0
fantasy_football_nerd,9,2,70,modified,70,0,spec/vcr/cassettes/Fantasy_Football_Nerd_Gem/should_retrieve_teams.yml,medium,0
fantasy_football_nerd,9,2,306,modified,306,0,spec/vcr/cassettes/Fantasy_Football_Nerd_Gem/should_retrieve_the_current_week.yml,medium,0
fantasy_football_nerd,9,2,1167,modified,1167,0,spec/vcr/cassettes/Fantasy_Football_Nerd_Gem/should_retrieve_the_ppr_draft_rankings.yml,medium,0
fantasy_football_nerd,9,2,306,modified,306,0,spec/vcr/cassettes/Fantasy_Football_Nerd_Gem/should_retrieve_the_schedule.yml,medium,0
fantasy_football_nerd,9,2,1167,modified,1167,0,spec/vcr/cassettes/Fantasy_Football_Nerd_Gem/should_retrieve_the_standard_draft_rankings.yml,medium,0
fantasy_football_nerd,9,2,105,modified,105,0,spec/vcr/cassettes/Fantasy_Football_Nerd_Gem/should_retrieve_weekly_projections.yml,medium,0
fantasy_football_nerd,9,2,109,modified,109,0,spec/vcr/cassettes/Fantasy_Football_Nerd_Gem/should_retrieve_weekly_rankings.yml,medium,0
fantasy_football_nerd,8,1,5,modified,2,3,README.md,low,0
fantasy_football_nerd,7,1,4,modified,2,2,README.md,low,0
fantasy_football_nerd,6,7,1,modified,1,0,.gitignore,low,0
fantasy_football_nerd,6,7,2,modified,1,1,Gemfile.lock,NaN,0
fantasy_football_nerd,6,7,54,modified,52,2,README.md,low,0
fantasy_football_nerd,6,7,7,modified,5,2,fantasy_football_nerd.gemspec,NaN,0
fantasy_football_nerd,6,7,7,modified,5,2,lib/fantasy_football_nerd.rb,high,0
fantasy_football_nerd,6,7,14,modified,13,1,lib/fantasy_football_nerd/commercial_feeds.rb,high,0
fantasy_football_nerd,6,7,1,modified,0,1,spec/commercial_feeds_spec.rb,high,0
fantasy_football_nerd,6,7,30,modified,30,0,spec/fantasy_football_nerd_spec.rb,high,0
fantasy_football_nerd,6,7,573,added,573,0,spec/vcr/cassettes/Fantasy_Football_Nerd_Gem/should_retrieve_Flacco_s_dfs_fanduel_projections.yml,medium,0
fantasy_football_nerd,6,7,6334,added,6334,0,spec/vcr/cassettes/Fantasy_Football_Nerd_Gem/should_retrieve_fanduel_s_league_info.yml,medium,0
fantasy_football_nerd,5,1,3,modified,1,2,lib/fantasy_football_nerd/commercial_feeds.rb,high,0
fantasy_football_nerd,4,2,5,modified,4,1,lib/fantasy_football_nerd.rb,high,0
fantasy_football_nerd,3,5,19,modified,19,0,lib/fantasy_football_nerd.rb,high,0
fantasy_football_nerd,3,5,31,modified,31,0,spec/fantasy_football_nerd_spec.rb,high,0
fantasy_football_nerd,3,5,1,modified,1,0,spec/spec_helper.rb,high,0
fantasy_football_nerd,1,2,94,modified,92,2,lib/fantasy_football_nerd.rb,high,1
fantasy_football_nerd,1,2,86,modified,81,5,spec/fantasy_football_nerd_spec.rb,high,1
fantasy_football_nerd,1,2,2715,added,2715,0,spec/vcr/cassettes/rankings.yml,medium,1
fantasy_football_nerd,1,2,829,added,829,0,spec/vcr/cassettes/schedule.yml,medium,1
football-stats,5,1,1,modified,0,1,lib/user_interaction.py,high,0
football-stats,5,1,3,modified,2,1,main.py,high,0
football-stats,4,1,24,modified,18,6,lib/average_coordinates.py,high,0
football-stats,4,1,40,modified,28,12,lib/coordinate_transform.py,high,0
football-stats,4,1,26,modified,16,10,lib/fgbg_calculations.py,high,0
football-stats,4,1,43,modified,36,7,lib/heatmap.py,high,0
football-stats,4,1,1,modified,1,0,lib/mouse.py,high,0
football-stats,4,1,22,modified,16,6,lib/polygon.py,high,0
football-stats,4,1,30,modified,14,16,lib/user_interaction.py,high,0
football-stats,4,1,10,modified,9,1,lib/video_source.py,high,0
football-stats,4,1,26,modified,11,15,main.py,high,0
football-stats,4,1,2,modified,1,1,test_scripts/window_to_field.py,high,0
football-stats,3,1,2,modified,1,1,README.bg.md,low,0
football-stats,3,1,4,modified,2,2,README.md,low,0
football-stats,1,2,99,added,99,0,README.bg.md,low,0
football-stats,1,2,121,removed,0,121,README.en.md,low,0
football-stats,1,2,156,modified,90,66,README.md,low,0
football.db,4,1,9,added,9,0,Gemfile,NaN,0
football.db,4,1,91,added,91,0,Gemfile.lock,NaN,0
football,1,1,1051,removed,0,1051,cstv/XML/576952_event.xml,medium,0
football,1,1,913,removed,0,913,cstv/XML/639276_event.xml,medium,0
football,1,1,1012,removed,0,1012,cstv/XML/669613_event.xml,medium,0
football,1,1,944,removed,0,944,cstv/XML/670806_event.xml,medium,0
football,1,1,1030,removed,0,1030,cstv/XML/681934_event.xml,medium,0
football,1,1,975,removed,0,975,cstv/XML/696102_event.xml,medium,0
football,1,1,900,removed,0,900,cstv/XML/709645_event.xml,medium,0
football,1,1,1092,removed,0,1092,cstv/XML/729828_event.xml,medium,0
football,1,1,1033,removed,0,1033,cstv/XML/738212_event.xml,medium,0
football,1,1,1074,removed,0,1074,cstv/XML/748868_event.xml,medium,0
football,1,1,1100,removed,0,1100,cstv/XML/754493_event.xml,medium,0
football,1,1,910,removed,0,910,cstv/XML/755086_event.xml,medium,0
football,1,1,0,removed,0,0,cstv/XML/755849_event.xml,medium,0
football,1,1,0,removed,0,0,cstv/XML/756087_event.xml,medium,0
football,1,1,0,removed,0,0,cstv/XML/756459_event.xml,medium,0
football,1,1,0,removed,0,0,cstv/XML/756587_event.xml,medium,0
football,1,1,0,removed,0,0,cstv/XML/756599_event.xml,medium,0
football,1,1,0,removed,0,0,cstv/XML/757335_event.xml,medium,0
football,1,1,0,removed,0,0,cstv/XML/758066_event.xml,medium,0
football,1,1,0,removed,0,0,cstv/XML/759992_event.xml,medium,0
football,1,1,0,removed,0,0,cstv/XML/760162_event.xml,medium,0
football,1,1,0,removed,0,0,cstv/XML/760163_event.xml,medium,0
football,1,1,0,removed,0,0,cstv/XML/761084_event.xml,medium,0
football,1,1,0,removed,0,0,cstv/XML/763789_event.xml,medium,0
football,1,1,0,removed,0,0,cstv/XML/767085_event.xml,medium,0
football,1,1,0,removed,0,0,cstv/XML/767263_event.xml,medium,0
football,1,1,0,removed,0,0,cstv/XML/767275_event.xml,medium,0
football,1,1,0,removed,0,0,cstv/XML/767291_event.xml,medium,0
football,1,1,0,removed,0,0,cstv/XML/767349_event.xml,medium,0
football,1,1,0,removed,0,0,cstv/XML/767367_event.xml,medium,0
itp-u3-c2-football-dictionaries,85,2,11,added,11,0,.idea/itp-u3-c2-football-dictionaries.iml,medium,0
itp-u3-c2-football-dictionaries,85,2,7,added,7,0,.idea/misc.xml,medium,0
itp-u3-c2-football-dictionaries,85,2,8,added,8,0,.idea/modules.xml,medium,0
itp-u3-c2-football-dictionaries,85,2,6,added,6,0,.idea/vcs.xml,medium,0
itp-u3-c2-football-dictionaries,85,2,334,added,334,0,.idea/workspace.xml,medium,0
DellXPS15-9550-OSX,67,1,1,added,1,0,Try,NaN,1
DellXPS15-9550-OSX,19,1,2,modified,1,1,Tutorial_10.12.md,low,0
DellXPS15-9550-OSX,13,1,2,modified,1,1,Tutorial_10.12.md,low,0
DellXPS15-9550-OSX,3,1,7,modified,7,0,10.12/Post-Install/AD-Kexts/AppleHDA_sysCL/install.sh,high,0
delly,122,1,14,modified,12,2,Makefile,high,0
delly,103,2,4,modified,2,2,src/util.h,high,0
delly,61,4,8,modified,6,2,README.md,low,0
delly,47,0,2,modified,1,1,docker/Dockerfile,low,1
delly,29,8,52,modified,51,1,vis/maze/README.md,low,0
delly,13,0,6,added,6,0,.gitmodules,low,0
delly,13,0,15,modified,12,3,Makefile,high,0
delly,13,0,1,added,1,0,src/bamtools,NaN,0
delly,13,0,1,added,1,0,src/htslib,NaN,0
delly,5,0,2,modified,1,1,README.md,low,0
delly,4,1,246,modified,123,123,human.hg19.excl.tsv,NaN,1
dell-xps-9560-ubuntu-respin,39,1,2,modified,2,0,README.md,low,0
dell-xps-9560-ubuntu-respin,33,1,2,modified,2,0,Dockerfile,low,0
dell-xps-9560-ubuntu-respin,30,1,0,renamed,0,0,docker-build-image.sh,high,0
XPS9350-macOS,187,1,17,modified,3,14,DSDT/patches/syscl_gpio_elan1200.txt,low,0
XPS9350-macOS,185,1,5,added,5,0,DSDT/patches/syscl_Win10I2C.txt,low,0
XPS9350-macOS,185,1,22,added,22,0,DSDT/patches/syscl_gpio_elan1200.txt,low,0
XPS9350-macOS,185,1,247,added,247,0,DSDT/patches/syscl_i2c.txt,low,0
XPS9350-macOS,185,1,9,added,9,0,DSDT/patches/syscl_i2ce.txt,low,0
XPS9350-macOS,185,1,10,modified,10,0,Deploy.sh,high,0
XPS9350-macOS,172,2,1,modified,1,0,.gitmodules,low,0
XPS9350-macOS,172,2,2,modified,1,1,README.md,low,0
XPS9350-macOS,172,2,2,modified,1,1,tools/macgen,NaN,0
XPS9350-macOS,170,1,14,modified,7,7,Kexts/Lilu.kext/Contents/Info.plist,medium,0
XPS9350-macOS,170,1,0,modified,0,0,Kexts/Lilu.kext/Contents/MacOS/Lilu,NaN,0
XPS9350-macOS,156,52,0,added,0,0,.DS_Store,NaN,0
XPS9350-macOS,156,52,0,added,0,0,CLOVER/.DS_Store,NaN,0
XPS9350-macOS,156,52,0,added,0,0,CLOVER/ACPI/.DS_Store,NaN,0
XPS9350-macOS,156,52,0,modified,0,0,CLOVER/CLOVERX64.efi,NaN,0
XPS9350-macOS,156,52,91,modified,62,29,CLOVER/config.plist,medium,0
XPS9350-macOS,156,52,0,modified,0,0,CLOVER/drivers64UEFI/AppleImageCodec-64.efi,NaN,0
XPS9350-macOS,156,52,0,modified,0,0,CLOVER/drivers64UEFI/AppleKeyAggregator-64.efi,NaN,0
XPS9350-macOS,156,52,0,removed,0,0,CLOVER/drivers64UEFI/AppleKeyMapAggregator.efi,NaN,0
XPS9350-macOS,156,52,0,modified,0,0,CLOVER/drivers64UEFI/AppleUITheme-64.efi,NaN,0
XPS9350-macOS,156,52,0,removed,0,0,CLOVER/drivers64UEFI/AsAmiShim.efi,NaN,0
XPS9350-macOS,156,52,0,modified,0,0,CLOVER/drivers64UEFI/DataHubDxe-64.efi,NaN,0
XPS9350-macOS,156,52,0,removed,0,0,CLOVER/drivers64UEFI/EmuVariableUefi-64.efi,NaN,0
XPS9350-macOS,156,52,0,modified,0,0,CLOVER/drivers64UEFI/FSInject-64.efi,NaN,0
XPS9350-macOS,156,52,0,modified,0,0,CLOVER/drivers64UEFI/FirmwareVolume-64.efi,NaN,0
XPS9350-macOS,156,52,0,modified,0,0,CLOVER/drivers64UEFI/OsxAptioFix2Drv-64.efi,NaN,0
XPS9350-macOS,156,52,0,added,0,0,CLOVER/drivers64UEFI/OsxFatBinaryDrv-64.efi,NaN,0
XPS9350-macOS,156,52,0,modified,0,0,CLOVER/drivers64UEFI/SMCHelper-64.efi,NaN,0
XPS9350-macOS,156,52,0,added,0,0,CLOVER/drivers64UEFI/apfs.efi,NaN,0
XPS9350-macOS,156,52,0,added,0,0,CLOVER/kexts/.DS_Store,NaN,0
XPS9350-macOS,156,52,16,renamed,8,8,CLOVER/kexts/10.12/HibernationFixup.kext/Contents/Info.plist,medium,0
XPS9350-macOS,156,52,0,added,0,0,CLOVER/kexts/10.12/HibernationFixup.kext/Contents/MacOS/HibernationFixup,NaN,0
XPS9350-macOS,156,52,0,added,0,0,CLOVER/kexts/10.13/.DS_Store,NaN,0
XPS9350-macOS,156,52,14,modified,7,7,CLOVER/kexts/10.13/ACPIBatteryManager.kext/Contents/Info.plist,medium,0
XPS9350-macOS,156,52,0,modified,0,0,CLOVER/kexts/10.13/ACPIBatteryManager.kext/Contents/MacOS/ACPIBatteryManager,NaN,0
XPS9350-macOS,156,52,26,modified,14,12,CLOVER/kexts/10.13/AppleBacklightInjector.kext/Contents/Info.plist,medium,0
XPS9350-macOS,156,52,14,modified,7,7,CLOVER/kexts/10.13/FakePCIID.kext/Contents/Info.plist,medium,0
XPS9350-macOS,156,52,0,modified,0,0,CLOVER/kexts/10.13/FakePCIID.kext/Contents/MacOS/FakePCIID,NaN,0
XPS9350-macOS,156,52,12,modified,6,6,CLOVER/kexts/10.13/FakePCIID_Broadcom_WiFi.kext/Contents/Info.plist,medium,0
XPS9350-macOS,156,52,24,modified,12,12,CLOVER/kexts/10.13/FakeSMC.kext/Contents/Info.plist,medium,0
XPS9350-macOS,156,52,0,modified,0,0,CLOVER/kexts/10.13/FakeSMC.kext/Contents/MacOS/FakeSMC,NaN,0
XPS9350-macOS,154,4,2,modified,1,1,.gitmodules,low,0
XPS9350-macOS,154,4,26,modified,15,11,Deploy.sh,high,0
XPS9350-macOS,154,4,2,modified,1,1,tools/macgen,NaN,0
XPS9350-macOS,149,1,127,removed,0,127,CLOVER/kexts/10.12/AirportBrcmFixup.kext/Contents/Info.plist,medium,0
XPS9350-macOS,149,1,0,removed,0,0,CLOVER/kexts/10.12/AirportBrcmFixup.kext/Contents/MacOS/AirportBrcmFixup,NaN,0
XPS9350-macOS,149,1,127,removed,0,127,CLOVER/kexts/10.13/AirportBrcmFixup.kext/Contents/Info.plist,medium,0
XPS9350-macOS,149,1,0,removed,0,0,CLOVER/kexts/10.13/AirportBrcmFixup.kext/Contents/MacOS/AirportBrcmFixup,NaN,0
XPS9350-macOS,147,2,77,modified,1,76,CLOVER/config.plist,medium,0
XPS9350-macOS,135,0,15,modified,10,5,README.md,low,0
XPS9350-macOS,101,2,0,added,0,0,CLOVER/drivers64UEFI/AppleKeyMapAggregator.efi,NaN,0
XPS9350-macOS,101,2,0,added,0,0,CLOVER/drivers64UEFI/AsAmiShim.efi,NaN,0
XPS9350-macOS,93,1,19,modified,10,9,README.md,low,1
XPS9350-macOS,83,0,17,modified,11,6,README.md,low,1
XPS9350-macOS,66,3,3,added,3,0,.gitmodules,low,0
XPS9350-macOS,66,3,2,modified,1,1,CLOVER/config.plist,medium,0
XPS9350-macOS,66,3,52,modified,52,0,Deploy.sh,high,0
XPS9350-macOS,66,3,1,added,1,0,tools/macgen,NaN,0
XPS9350-macOS,58,5,1,added,1,0,.gitignore,low,1
XPS9350-macOS,58,5,3,added,3,0,.gitmodules,low,1
XPS9350-macOS,58,5,3,modified,2,1,CLOVER/config.plist,medium,1
XPS9350-macOS,58,5,92,modified,65,27,CLOVER/kexts/10.12/ApplePS2SmartTouchPad.kext/Contents/Info.plist,medium,1
XPS9350-macOS,58,5,0,modified,0,0,CLOVER/kexts/10.12/ApplePS2SmartTouchPad.kext/Contents/MacOS/ApplePS2SmartTouchPad,NaN,1
XPS9350-macOS,58,5,8,modified,4,4,CLOVER/kexts/10.12/ApplePS2SmartTouchPad.kext/Contents/PlugIns/ApplePS2Controller.kext/Contents/Info.plist,medium,1
XPS9350-macOS,58,5,0,modified,0,0,CLOVER/kexts/10.12/ApplePS2SmartTouchPad.kext/Contents/PlugIns/ApplePS2Controller.kext/Contents/MacOS/ApplePS2Controller,NaN,1
XPS9350-macOS,58,5,20,modified,11,9,CLOVER/kexts/10.12/ApplePS2SmartTouchPad.kext/Contents/PlugIns/ApplePS2Keyboard.kext/Contents/Info.plist,medium,1
XPS9350-macOS,58,5,0,modified,0,0,CLOVER/kexts/10.12/ApplePS2SmartTouchPad.kext/Contents/PlugIns/ApplePS2Keyboard.kext/Contents/MacOS/ApplePS2Keyboard,NaN,1
XPS9350-macOS,58,5,0,modified,0,0,CLOVER/kexts/10.12/ApplePS2SmartTouchPad.kext/Contents/Resources/Features Documentation.rtfd/11493706554_130fa58d5f_n.jpg,low,1
XPS9350-macOS,58,5,0,modified,0,0,CLOVER/kexts/10.12/ApplePS2SmartTouchPad.kext/Contents/Resources/Features Documentation.rtfd/8524384148_7da070dae6_c.jpg,low,1
XPS9350-macOS,58,5,0,modified,0,0,CLOVER/kexts/10.12/ApplePS2SmartTouchPad.kext/Contents/Resources/Features Documentation.rtfd/9718452526_b6414cd8e7_n.jpg,low,1
XPS9350-macOS,58,5,0,modified,0,0,CLOVER/kexts/10.12/ApplePS2SmartTouchPad.kext/Contents/Resources/Features Documentation.rtfd/TXT.rtf,NaN,1
XPS9350-macOS,58,5,0,modified,0,0,CLOVER/kexts/10.12/ApplePS2SmartTouchPad.kext/Contents/Resources/Synaptics documentation.rtfd/TXT.rtf,NaN,1
XPS9350-macOS,58,5,0,modified,0,0,CLOVER/kexts/10.12/ApplePS2SmartTouchPad.kext/Contents/Resources/Synaptics documentation.rtfd/page30image13008.png,low,1
XPS9350-macOS,58,5,0,modified,0,0,CLOVER/kexts/10.12/ApplePS2SmartTouchPad.kext/Contents/Resources/Synaptics documentation.rtfd/page30image13432.png,low,1
XPS9350-macOS,58,5,0,modified,0,0,CLOVER/kexts/10.12/ApplePS2SmartTouchPad.kext/Contents/Resources/Synaptics documentation.rtfd/page30image13912.png,low,1
XPS9350-macOS,58,5,0,modified,0,0,CLOVER/kexts/10.12/ApplePS2SmartTouchPad.kext/Contents/Resources/Synaptics documentation.rtfd/page30image14840.png,low,1
XPS9350-macOS,58,5,0,modified,0,0,CLOVER/kexts/10.12/ApplePS2SmartTouchPad.kext/Contents/Resources/Synaptics documentation.rtfd/page30image15160.png,low,1
XPS9350-macOS,58,5,0,modified,0,0,CLOVER/kexts/10.12/ApplePS2SmartTouchPad.kext/Contents/Resources/Synaptics documentation.rtfd/page30image16448.png,low,1
XPS9350-macOS,58,5,0,modified,0,0,CLOVER/kexts/10.12/ApplePS2SmartTouchPad.kext/Contents/Resources/Synaptics documentation.rtfd/page30image16608.png,low,1
XPS9350-macOS,58,5,0,modified,0,0,CLOVER/kexts/10.12/ApplePS2SmartTouchPad.kext/Contents/Resources/Synaptics documentation.rtfd/page30image18496.png,low,1
XPS9350-macOS,58,5,0,modified,0,0,CLOVER/kexts/10.12/ApplePS2SmartTouchPad.kext/Contents/Resources/Synaptics documentation.rtfd/page30image18808.png,low,1
XPS9350-macOS,58,5,0,modified,0,0,CLOVER/kexts/10.12/ApplePS2SmartTouchPad.kext/Contents/Resources/Synaptics documentation.rtfd/page30image20328.png,low,1
XPS9350-macOS,58,5,0,modified,0,0,CLOVER/kexts/10.12/ApplePS2SmartTouchPad.kext/Contents/Resources/Synaptics documentation.rtfd/page30image21840.png,low,1
XPS9350-macOS,58,5,0,modified,0,0,CLOVER/kexts/10.12/ApplePS2SmartTouchPad.kext/Contents/Resources/Synaptics documentation.rtfd/page30image22000.png,low,1
XPS9350-macOS,58,5,0,modified,0,0,CLOVER/kexts/10.12/ApplePS2SmartTouchPad.kext/Contents/Resources/Synaptics documentation.rtfd/page30image24168.png,low,1
XPS9350-macOS,58,5,0,modified,0,0,CLOVER/kexts/10.12/ApplePS2SmartTouchPad.kext/Contents/Resources/Synaptics documentation.rtfd/page30image24328.png,low,1
XPS9350-macOS,58,5,0,modified,0,0,CLOVER/kexts/10.12/ApplePS2SmartTouchPad.kext/Contents/Resources/Synaptics documentation.rtfd/page30image25088.png,low,1
XPS9350-macOS,58,5,0,modified,0,0,CLOVER/kexts/10.12/ApplePS2SmartTouchPad.kext/Contents/Resources/Synaptics documentation.rtfd/page30image25248.png,low,1
xps13,102,1,8,removed,0,8,A11_02/.xsession,NaN,0
xps13,102,1,12,added,12,0,A14_01/.xsession,NaN,0
xps13,102,1,0,renamed,0,0,A14_01/intel-hda.conf,NaN,0
xps13,102,1,0,renamed,0,0,A14_01/psmouse-blacklist.conf,NaN,0
xps13,102,1,56,modified,30,26,configurations.md,low,0
xps13,100,1,3,modified,2,1,README.md,low,0
xps13,97,2,0,renamed,0,0,A04_03/50-synaptics.conf,NaN,0
xps13,97,2,0,renamed,0,0,A04_03/99-no-touchscreen.conf,NaN,0
xps13,97,2,0,renamed,0,0,A05_02/configure_touchpad.sh,high,0
xps13,97,2,0,renamed,0,0,A05_02/console-setup,NaN,0
xps13,97,2,0,renamed,0,0,A05_02/rc.local,NaN,0
xps13,97,2,0,renamed,0,0,A11_02/.xsession,NaN,0
xps13,97,2,0,renamed,0,0,A11_02/intel-hda.conf,NaN,0
xps13,97,2,0,renamed,0,0,A11_02/psmouse-blacklist.conf,NaN,0
xps13,97,2,21,modified,10,11,README.md,low,0
xps13,97,2,73,modified,39,34,configurations.md,low,0
xps13,93,1,10,modified,6,4,README.md,low,0
xps13,92,3,8,modified,5,3,README.md,low,0
xps13,87,1,2,modified,1,1,configurations.md,low,1
xps13,80,1,4,removed,0,4,A05_02/i915.conf,NaN,0
xps13,80,1,0,renamed,0,0,A07_01/.xsession,NaN,0
xps13,80,1,0,renamed,0,0,A07_01/intel-hda.conf,NaN,0
xps13,80,1,0,renamed,0,0,A07_01/psmouse-blacklist.conf,NaN,0
xps13,80,1,63,modified,33,30,configurations.md,low,1
xps13,76,3,16,modified,15,1,README.md,low,0
xps13,65,1,1,modified,1,0,README.md,low,0
xps13,63,3,14,modified,10,4,configurations.md,low,1
xps13,62,0,46,modified,24,22,README.md,low,0
xps13,61,1,4,modified,2,2,configurations.md,low,1
xps13,59,1,17,modified,17,0,configurations.md,low,1
xps13,55,1,5,modified,3,2,configurations.md,low,1
xps13,52,1,33,modified,17,16,configurations.md,low,1
xps13,51,0,4,modified,2,2,README.md,low,0
xps13,49,1,3,modified,3,0,README.md,low,0
xps13,48,3,8,added,8,0,A05_02/.xsession,NaN,0
xps13,48,3,4,added,4,0,A05_02/i915.conf,NaN,0
xps13,48,3,4,added,4,0,A05_02/intel-hda.conf,NaN,0
xps13,48,3,4,added,4,0,A05_02/psmouse-blacklist.conf,NaN,0
xps13,48,3,1,modified,1,0,README.md,low,0
xps13,48,3,29,modified,29,0,configurations.md,low,1
xps13,44,1,22,modified,13,9,configurations.md,low,1
xps13,42,1,80,added,80,0,A04_06/50-synaptics.conf,NaN,0
xps13,42,1,6,added,6,0,A04_06/99-no-touchscreen.conf,NaN,0
xps13,42,1,22,modified,22,0,configurations.md,low,1
xps13,41,0,2,modified,1,1,README.md,low,0
xps13,40,1,18,modified,9,9,configurations.md,low,1
xps13,38,1,3,modified,2,1,configurations.md,low,1
xps13,37,1,2,modified,1,1,A03_03/rc.local,NaN,0
xps13,36,2,7,modified,4,3,configurations.md,low,1
xps13,35,1,2,modified,1,1,configurations.md,low,1
xps13,34,4,26,removed,0,26,A03_03/50-synaptics.conf,NaN,0
xps13,34,4,7,added,7,0,alessio/configure_touchpad.sh,high,0
xps13,34,4,10,modified,5,5,configurations.md,low,1
xps13,33,1,2,modified,0,2,configurations.md,low,1
xps13,31,1,18,modified,9,9,configurations.md,low,1
xps13,29,2,32,modified,17,15,configurations.md,low,1
xps13,28,2,14,modified,11,3,configurations.md,low,1
xps13,26,2,121,modified,1,120,README.md,low,0
xps13,26,2,131,added,131,0,configurations.md,low,1
xps13,24,1,10,modified,10,0,README.md,low,0
xps13,21,0,10,modified,5,5,README.md,low,0
xps13,20,2,6,modified,3,3,README.md,low,0
xps13,19,2,12,modified,11,1,README.md,low,0
xps13,17,1,10,modified,10,0,README.md,low,0
xps13,15,7,11,modified,7,4,README.md,low,0
xps13,15,7,26,added,26,0,config9/50-synaptics.conf,NaN,0
xps13,15,7,16,added,16,0,config9/console-setup,NaN,0
xps13,15,7,17,added,17,0,config9/rc.local,NaN,0
xps13,14,2,11,modified,11,0,README.md,low,0
xps13,13,0,3,modified,2,1,README.md,low,0
xps13,11,0,8,modified,8,0,README.md,low,0
xps13,9,0,2,modified,1,1,config7/90-eDP1.conf,NaN,0
xps13,8,0,9,modified,9,0,README.md,low,0
xps13,8,0,7,added,7,0,config7/90-eDP1.conf,NaN,0
xps13,7,0,4,modified,2,2,README.md,low,0
xps13,6,0,2,modified,1,1,README.md,low,0
xps13,5,0,1,modified,1,0,README.md,low,0
xps13,4,0,15,modified,14,1,README.md,low,0
xps13,3,0,9,modified,5,4,README.md,low,0
xps13,2,0,8,modified,7,1,README.md,low,0
xps13,1,0,4,modified,4,0,README.md,low,0
XPS9360-macOS,76,7,0,modified,0,0,CLOVER/ACPI/patched/SSDT-Config.aml,NaN,0
XPS9360-macOS,76,7,2,modified,1,1,DSDT/SSDT-Config.dsl,NaN,0
XPS9360-macOS,76,7,3,modified,2,1,README.md,low,0
XPS9360-macOS,76,7,14,modified,14,0,XPS9360.sh,high,0
XPS9360-macOS,76,7,0,added,0,0,audio/ALCPlugFix,NaN,0
XPS9360-macOS,76,7,2,modified,1,1,audio/ahhcd.plist,medium,0
XPS9360-macOS,76,7,18,added,18,0,audio/good.win.ALCPlugFix.plist,medium,0
XPS9360-macOS,76,7,0,added,0,0,audio/hda-verb,NaN,0
XPS9360-macOS,76,7,2,renamed,1,1,audio/layout2.plist,medium,0
XPS9360-macOS,59,1,24,added,24,0,Displays/QHD+/DisplayProductID-144a,NaN,0
XPS9360-macOS,59,1,3,modified,3,0,Displays/profiles.txt,low,0
XPS9360-macOS,37,1,4,modified,2,2,README.md,low,0
puppet-dell,80,1,2,modified,1,1,lib/facter/warranty.rb,high,0
puppet-dell,79,1,3,modified,0,3,manifests/openmanage/debian.pp,NaN,0
puppet-dell,78,0,1,modified,1,0,.fixtures.yml,medium,0
puppet-dell,78,0,18,modified,0,18,.travis.yml,medium,0
puppet-dell,78,0,33,modified,17,16,files/etc/pki/rpm-gpg/RPM-GPG-KEY-dell,NaN,0
puppet-dell,78,0,25,removed,0,25,files/etc/pki/rpm-gpg/RPM-GPG-KEY-libsmbios,NaN,0
puppet-dell,78,0,6,modified,0,6,manifests/hwtools.pp,NaN,0
puppet-dell,78,0,22,modified,20,2,manifests/hwtools/package.pp,NaN,0
puppet-dell,78,0,39,modified,15,24,manifests/hwtools/repo.pp,NaN,0
puppet-dell,78,0,4,modified,2,2,manifests/init.pp,NaN,0
puppet-dell,78,0,28,modified,22,6,manifests/openmanage.pp,NaN,0
puppet-dell,78,0,40,modified,26,14,manifests/openmanage/redhat.pp,NaN,0
puppet-dell,78,0,29,modified,7,22,manifests/params.pp,NaN,0
puppet-dell,78,0,6,modified,4,2,metadata.json,medium,0
puppet-dell,78,0,16,removed,0,16,spec/acceptance/nodesets/centos-5.yml,medium,0
puppet-dell,78,0,1,modified,1,0,spec/spec_helper_acceptance.rb,high,0
puppet-dell,77,0,33,modified,17,16,files/etc/pki/rpm-gpg/RPM-GPG-KEY-dell,NaN,1
puppet-dell,77,0,25,removed,0,25,files/etc/pki/rpm-gpg/RPM-GPG-KEY-libsmbios,NaN,1
puppet-dell,77,0,6,modified,0,6,manifests/hwtools.pp,NaN,1
puppet-dell,77,0,25,modified,23,2,manifests/hwtools/package.pp,NaN,1
puppet-dell,77,0,34,modified,12,22,manifests/hwtools/repo.pp,NaN,1
puppet-dell,77,0,3,modified,1,2,manifests/init.pp,NaN,1
puppet-dell,77,0,28,modified,22,6,manifests/openmanage.pp,NaN,1
puppet-dell,77,0,40,modified,26,14,manifests/openmanage/redhat.pp,NaN,1
puppet-dell,77,0,29,modified,7,22,manifests/params.pp,NaN,1
puppet-dell,76,2,2,modified,1,1,manifests/hwtools/package.pp,NaN,1
puppet-dell,76,2,6,modified,0,6,manifests/openmanage/redhat.pp,NaN,1
puppet-dell,75,2,28,modified,8,20,manifests/init.pp,NaN,1
puppet-dell,74,1,2,modified,1,1,manifests/params.pp,NaN,1
puppet-dell,72,0,14,modified,14,0,README.md,low,0
puppet-dell,72,0,101,removed,0,101,lib/facter/util/warranty.rb,high,0
puppet-dell,72,0,222,modified,156,66,lib/facter/warranty.rb,high,0
puppet-dell,72,0,7,modified,7,0,manifests/init.pp,NaN,1
puppet-dell,72,0,2,modified,1,1,manifests/params.pp,NaN,1
puppet-dell,72,0,45,modified,7,38,manifests/warranty.pp,NaN,0
puppet-dell,71,1,11,modified,6,5,manifests/init.pp,NaN,1
puppet-dell,71,1,4,modified,3,1,manifests/openmanage/debian.pp,NaN,0
puppet-dell,71,1,2,modified,2,0,manifests/params.pp,NaN,1
puppet-dell,70,1,5,modified,4,1,lib/facter/warranty.rb,high,1
puppet-dell,68,1,4,modified,2,2,manifests/params.pp,NaN,1
puppet-dell,65,1,6,modified,6,0,spec/spec_helper_acceptance.rb,high,0
puppet-dell,64,1,2,modified,1,1,manifests/params.pp,NaN,1
puppet-dell,62,2,2,modified,1,1,manifests/hwtools.pp,NaN,2
puppet-dell,62,2,13,modified,5,8,manifests/snmp.pp,NaN,1
puppet-dell,61,1,3,modified,3,0,manifests/openmanage/debian.pp,NaN,1
puppet-dell,60,15,33,modified,17,16,files/etc/pki/rpm-gpg/RPM-GPG-KEY-dell,NaN,2
puppet-dell,60,15,25,removed,0,25,files/etc/pki/rpm-gpg/RPM-GPG-KEY-libsmbios,NaN,2
puppet-dell,60,15,65,modified,5,60,manifests/hwtools.pp,NaN,3
puppet-dell,60,15,36,added,36,0,manifests/hwtools/package.pp,NaN,2
puppet-dell,60,15,41,added,41,0,manifests/hwtools/repo.pp,NaN,2
puppet-dell,60,15,8,modified,3,5,manifests/init.pp,NaN,2
puppet-dell,60,15,12,modified,12,0,manifests/openmanage.pp,NaN,2
puppet-dell,60,15,1,modified,1,0,manifests/openmanage/debian.pp,NaN,2
puppet-dell,60,15,42,modified,25,17,manifests/openmanage/redhat.pp,NaN,2
puppet-dell,60,15,29,modified,6,23,manifests/params.pp,NaN,2
puppet-dell,60,15,2,modified,1,1,spec/acceptance/dell__openmanage_spec.rb,high,1
puppet-dell,59,2,2,modified,1,1,manifests/hwtools.pp,NaN,4
puppet-dell,59,2,6,modified,0,6,manifests/openmanage/redhat.pp,NaN,3
puppet-dell,57,3,33,modified,17,16,files/etc/pki/rpm-gpg/RPM-GPG-KEY-dell,NaN,3
puppet-dell,57,3,25,removed,0,25,files/etc/pki/rpm-gpg/RPM-GPG-KEY-libsmbios,NaN,3
puppet-dell,57,3,56,modified,36,20,manifests/hwtools.pp,NaN,5
puppet-dell,57,3,8,modified,3,5,manifests/init.pp,NaN,3
puppet-dell,57,3,12,modified,12,0,manifests/openmanage.pp,NaN,3
puppet-dell,57,3,37,modified,23,14,manifests/openmanage/redhat.pp,NaN,4
puppet-dell,57,3,29,modified,6,23,manifests/params.pp,NaN,3
puppet-dell,57,3,2,modified,1,1,spec/acceptance/dell__openmanage_spec.rb,high,2
puppet-dell,56,1,4,modified,2,2,manifests/openmanage/redhat.pp,NaN,4
puppet-dell,55,1,6,modified,3,3,manifests/openmanage/debian.pp,NaN,2
puppet-dell,54,1,8,modified,8,0,manifests/openmanage/debian.pp,NaN,2
puppet-dell,53,3,2,modified,1,1,lib/facter/dell_express_service_code.rb,high,0
puppet-dell,53,3,2,modified,1,1,lib/facter/warranty.rb,high,1
puppet-dell,53,3,3,modified,2,1,manifests/warranty.pp,NaN,0
puppet-dell,52,1,3,modified,2,1,manifests/warranty.pp,NaN,1
puppet-dell,51,0,68,modified,48,20,manifests/params.pp,NaN,3
puppet-dell,51,0,29,modified,25,4,spec/classes/dell_spec.rb,high,0
puppet-dell,50,1,65,modified,8,57,manifests/hwtools.pp,NaN,5
puppet-dell,50,1,19,added,19,0,manifests/hwtools/package.pp,NaN,2
puppet-dell,50,1,37,added,37,0,manifests/hwtools/repo.pp,NaN,2
puppet-dell,49,0,33,modified,21,12,manifests/hwtools.pp,NaN,5
puppet-dell,49,0,33,modified,21,12,manifests/openmanage/redhat.pp,NaN,4
puppet-dell,49,0,2,modified,1,1,manifests/warranty.pp,NaN,1
puppet-dell,48,1,6,modified,3,3,manifests/openmanage.pp,NaN,3
puppet-dell,48,1,18,modified,18,0,spec/classes/dell_spec.rb,high,0
puppet-dell,45,1,2,modified,2,0,manifests/openmanage/debian.pp,NaN,2
puppet-dell,45,1,2,modified,1,1,manifests/params.pp,NaN,3
puppet-dell,44,0,12,modified,11,1,manifests/openmanage.pp,NaN,4
puppet-dell,44,0,1,modified,1,0,manifests/openmanage/debian.pp,NaN,3
puppet-dell,44,0,2,modified,1,1,manifests/params.pp,NaN,4
puppet-dell,43,0,11,modified,11,0,manifests/hwtools.pp,NaN,6
puppet-dell,43,0,12,modified,11,1,manifests/openmanage.pp,NaN,5
puppet-dell,43,0,6,modified,6,0,manifests/openmanage/debian.pp,NaN,4
puppet-dell,43,0,2,modified,1,1,manifests/params.pp,NaN,5
puppet-dell,42,1,77,modified,21,56,manifests/params.pp,NaN,5
puppet-dell,40,4,101,added,101,0,lib/facter/util/warranty.rb,high,0
puppet-dell,40,4,129,modified,81,48,lib/facter/warranty.rb,high,1
puppet-dell,39,1,8,modified,6,2,manifests/hwtools.pp,NaN,6
puppet-dell,39,1,20,added,20,0,manifests/init.pp,NaN,3
puppet-dell,39,1,8,modified,4,4,manifests/openmanage.pp,NaN,5
puppet-dell,39,1,22,modified,13,9,manifests/openmanage/debian.pp,NaN,4
puppet-dell,39,1,6,modified,4,2,manifests/openmanage/redhat.pp,NaN,4
puppet-dell,39,1,20,modified,11,9,manifests/warranty.pp,NaN,1
puppet-dell,38,0,7,modified,5,2,manifests/openmanage/debian.pp,NaN,4
puppet-dell,38,0,20,modified,17,3,manifests/params.pp,NaN,5
puppet-dell,37,0,11,modified,11,0,manifests/hwtools.pp,NaN,7
puppet-dell,37,0,12,modified,11,1,manifests/openmanage.pp,NaN,6
puppet-dell,37,0,5,modified,5,0,manifests/openmanage/debian.pp,NaN,5
puppet-dell,34,0,52,added,52,0,lib/facter/dell_warranty.rb,high,1
puppet-dell,34,0,52,removed,0,52,lib/facter/warranty.rb,high,2
puppet-dell,33,0,11,added,11,0,lib/facter/dell_express_service_code.rb,high,0
puppet-dell,32,0,55,modified,54,1,manifests/openmanage/debian.pp,NaN,5
puppet-dell,31,0,4,modified,4,0,manifests/params.pp,NaN,5
puppet-dell,30,0,2,modified,1,1,manifests/params.pp,NaN,5
puppet-dell,29,0,3,modified,1,2,manifests/hwtools.pp,NaN,7
puppet-dell,29,0,5,modified,5,0,manifests/params.pp,NaN,5
puppet-dell,28,0,2,modified,1,1,manifests/openmanage/debian.pp,NaN,5
puppet-dell,28,0,28,modified,14,14,manifests/params.pp,NaN,5
puppet-dell,27,0,86,modified,83,3,manifests/openmanage/debian.pp,NaN,5
puppet-dell,27,0,36,modified,25,11,manifests/params.pp,NaN,5
puppet-dell,26,0,629,added,629,0,files/etc/init.d/dsm_sa_ipmi.RedHat.6.4,NaN,0
puppet-dell,26,0,22,modified,22,0,manifests/openmanage/redhat.pp,NaN,4
puppet-dell,25,0,37,modified,23,14,manifests/params.pp,NaN,5
puppet-dell,24,0,10,modified,10,0,manifests/params.pp,NaN,5
puppet-dell,24,0,32,added,32,0,manifests/warranty.pp,NaN,1
puppet-dell,23,0,5,modified,5,0,manifests/params.pp,NaN,6
puppet-dell,23,0,30,added,30,0,manifests/warranty.pp,NaN,2
puppet-dell,22,1,35,modified,18,17,manifests/collectd.pp,NaN,0
puppet-dell,22,1,2,added,2,0,templates/collectd-footer.conf,NaN,0
puppet-dell,22,1,6,added,6,0,templates/collectd-header.conf,NaN,0
puppet-dell,22,1,10,modified,1,9,templates/collectd.conf,NaN,0
puppet-dell,21,1,6,modified,4,2,lib/facter/warranty.rb,high,2
puppet-dell,20,0,34,removed,0,34,lib/facter/isopenmanagesupported.rb,high,0
puppet-dell,20,0,8,removed,0,8,lib/facter/srvadminpkgcount.rb,high,0
puppet-dell,20,0,43,modified,21,22,manifests/collectd.pp,NaN,0
puppet-dell,20,0,8,modified,6,2,manifests/hwtools.pp,NaN,7
puppet-dell,20,0,104,modified,45,59,manifests/openmanage.pp,NaN,6
puppet-dell,20,0,5,modified,5,0,manifests/openmanage/debian.pp,NaN,5
puppet-dell,20,0,8,modified,6,2,manifests/openmanage/redhat.pp,NaN,4
puppet-dell,20,0,10,modified,8,2,manifests/params.pp,NaN,6
puppet-dell,20,0,11,modified,5,6,manifests/snmp.pp,NaN,1
puppet-dell,19,1,7,modified,5,2,lib/facter/warranty.rb,high,2
puppet-dell,18,1,1,modified,0,1,manifests/openmanage.pp,NaN,7
puppet-dell,17,7,20,modified,11,9,manifests/collectd.pp,NaN,0
puppet-dell,17,7,39,modified,21,18,manifests/hwtools.pp,NaN,7
puppet-dell,17,7,37,modified,19,18,manifests/openmanage.pp,NaN,7
puppet-dell,17,7,20,modified,11,9,manifests/openmanage/debian.pp,NaN,5
puppet-dell,17,7,32,modified,19,13,manifests/openmanage/redhat.pp,NaN,4
puppet-dell,17,7,8,modified,4,4,manifests/params.pp,NaN,6
puppet-dell,17,7,16,modified,8,8,manifests/snmp.pp,NaN,1
puppet-dell,16,0,2,modified,1,1,lib/facter/isopenmanagesupported.rb,high,1
puppet-dell,16,0,6,modified,3,3,manifests/hwtools.pp,NaN,8
puppet-dell,16,0,5,modified,2,3,manifests/openmanage.pp,NaN,8
puppet-dell,16,0,20,modified,16,4,manifests/openmanage/debian.pp,NaN,6
puppet-dell,15,0,2,modified,1,1,lib/facter/isopenmanagesupported.rb,high,2
puppet-dell,15,0,6,modified,3,3,manifests/hwtools.pp,NaN,9
puppet-dell,15,0,5,modified,2,3,manifests/openmanage.pp,NaN,9
puppet-dell,15,0,20,modified,16,4,manifests/openmanage/debian.pp,NaN,7
puppet-dell,13,1,4,modified,2,2,lib/facter/warranty.rb,high,2
puppet-dell,12,0,20,modified,10,10,lib/facter/warranty.rb,high,2
puppet-dell,11,0,5,modified,3,2,lib/facter/warranty.rb,high,2
puppet-dell,10,0,4,modified,2,2,lib/facter/warranty.rb,high,2
puppet-dell,9,0,61,modified,13,48,lib/facter/warranty.rb,high,2
puppet-dell,8,1,2,modified,1,1,manifests/openmanage/redhat.pp,NaN,4
puppet-dell,7,1,9,modified,1,8,manifests/snmp.pp,NaN,1
puppet-dell,6,0,13,modified,10,3,manifests/snmp.pp,NaN,1
puppet-dell,5,1,2,modified,1,1,lib/facter/isopenmanagesupported.rb,high,2
puppet-dell,4,0,31,modified,30,1,manifests/openmanage/debian.pp,NaN,7
puppet-dell,3,1,3,modified,2,1,manifests/classes/dell-openmanage.pp,NaN,1
puppet-dell,2,4,2,modified,1,1,lib/facter/isopenmanagesupported.rb,high,2
puppet-dell,2,4,2,modified,1,1,manifests/classes/dell-collectd.pp,NaN,0
puppet-dell,2,4,3,modified,2,1,manifests/classes/dell-hwtool.pp,NaN,0
puppet-dell,2,4,4,modified,2,2,manifests/classes/dell-openmanage-debian.pp,NaN,0
puppet-dell,2,4,1,modified,1,0,manifests/classes/dell-openmanage-redhat.pp,NaN,0
puppet-dell,2,4,3,modified,1,2,manifests/classes/dell-openmanage.pp,NaN,1
puppet-dell,1,0,18,modified,9,9,manifests/classes/dell-hwtool.pp,NaN,0
puppet-dell,1,0,19,added,19,0,manifests/classes/dell-openmanage-debian.pp,NaN,0
puppet-dell,1,0,44,added,44,0,manifests/classes/dell-openmanage-redhat.pp,NaN,0
puppet-dell,1,0,65,modified,0,65,manifests/classes/dell-openmanage.pp,NaN,1
puppet-dell,1,0,23,added,23,0,manifests/classes/dell-params.pp,NaN,0
dell-idrac,289,1,1,modified,1,0,Gemfile,NaN,0
dell-idrac,288,8,1,modified,1,0,Gemfile,NaN,1
dell-idrac,280,1,2,modified,2,0,.gitignore,low,0
dell-idrac,280,1,8,modified,4,4,.travis.yml,medium,0
dell-idrac,280,1,10,modified,5,5,Gemfile,NaN,1
dell-idrac,280,1,6,modified,4,2,spec/spec_helper.rb,high,0
dell-idrac,279,1,55,modified,25,30,lib/puppet/provider/importtemplatexml.rb,high,0
dell-idrac,279,1,10,modified,7,3,spec/unit/puppet/provider/importtemplatexml_spec.rb,high,0
dell-idrac,278,1,34,modified,28,6,lib/puppet/provider/importtemplatexml.rb,high,0
dell-idrac,278,1,110,added,110,0,spec/fixtures/boot_sources.json,medium,0
dell-idrac,278,1,110,added,110,0,spec/fixtures/satadom_boot_sources.json,medium,0
dell-idrac,278,1,23,modified,23,0,spec/unit/puppet/provider/importtemplatexml_spec.rb,high,0
dell-idrac,277,1,75,modified,71,4,lib/puppet/provider/importtemplatexml.rb,high,0
dell-idrac,277,1,170,added,170,0,spec/fixtures/boss_controller_view.json,medium,0
dell-idrac,277,1,162,added,162,0,spec/fixtures/controller_view.json,medium,0
dell-idrac,277,1,1,removed,0,1,spec/fixtures/controller_view.xml,medium,0
dell-idrac,277,1,576,added,576,0,spec/fixtures/physical_disks.xml,medium,0
dell-idrac,277,1,537,added,537,0,spec/fixtures/physical_disks_one_disk.xml,medium,0
dell-idrac,277,1,49,modified,47,2,spec/unit/puppet/provider/importtemplatexml_spec.rb,high,0
dell-idrac,276,1,16,modified,6,10,lib/puppet/provider/importtemplatexml.rb,high,0
dell-idrac,275,4,5,modified,2,3,.travis.yml,medium,1
dell-idrac,275,4,8,modified,4,4,Gemfile,NaN,2
dell-idrac,274,1,2,modified,1,1,Gemfile,NaN,2
dell-idrac,273,2,6,modified,3,3,Gemfile,NaN,2
dell-idrac,273,2,2,modified,1,1,lib/puppet/provider/importtemplatexml.rb,high,0
dell-idrac,272,1,4,modified,2,2,Gemfile,NaN,2
dell-idrac,272,1,2,modified,1,1,lib/puppet/provider/importtemplatexml.rb,high,0
dell-idrac,271,1,2,modified,1,1,Gemfile,NaN,3
dell-idrac,270,1,2,modified,1,1,Gemfile,NaN,3
dell-idrac,257,1,1,added,1,0,spec/fixtures/mock_nfs/EXPORT_original.xml,medium,0
dell-idrac,256,1,6,modified,3,3,Rakefile,NaN,0
dell-idrac,255,1,7,modified,6,1,lib/puppet/idrac/util.rb,high,0
dell-idrac,255,1,88,modified,84,4,lib/puppet/provider/importtemplatexml.rb,high,0
dell-idrac,255,1,1,added,1,0,spec/fixtures/controller_view.xml,medium,0
dell-idrac,255,1,474,added,474,0,spec/fixtures/physical_disk_view.xml,medium,0
dell-idrac,255,1,45,modified,45,0,spec/unit/puppet/provider/importtemplatexml_spec.rb,high,0
dell-idrac,254,1,62,modified,37,25,lib/puppet/provider/importtemplatexml.rb,high,0
dell-idrac,254,1,114,modified,114,0,spec/unit/puppet/provider/importtemplatexml_spec.rb,high,0
dell-idrac,253,1,3,added,3,0,.fixtures.yml,medium,0
dell-idrac,251,3,1,modified,1,0,.gitignore,low,0
dell-idrac,251,3,41,modified,39,2,lib/puppet/provider/importtemplatexml.rb,high,0
dell-idrac,251,3,23,added,23,0,spec/fixtures/BARTAG_original.xml,medium,0
dell-idrac,251,3,1,modified,1,0,spec/fixtures/FOOTAG_original.xml,medium,0
dell-idrac,240,1,1,modified,1,0,Gemfile,NaN,3
dell-idrac,240,1,17,modified,16,1,lib/puppet/provider/importtemplatexml.rb,high,0
dell-idrac,239,2,1,modified,1,0,Gemfile,NaN,4
dell-idrac,239,2,2,modified,1,1,lib/puppet/idrac/util.rb,high,2
dell-idrac,239,2,64,added,64,0,spec/fixtures/VirtualDiskView.xml,medium,1
dell-idrac,239,2,64,added,64,0,spec/fixtures/VirtualDiskView2.xml,medium,1
dell-idrac,231,1,4,modified,4,0,Gemfile,NaN,5
dell-idrac,231,1,48,added,48,0,bin/discovery.rb,high,1
dell-idrac,231,1,104,added,104,0,lib/discovery.rb,high,1
dell-idrac,231,1,15,added,15,0,spec/fixtures/discovery_result.xml,medium,1
dell-idrac,198,1,17,modified,14,3,Gemfile,NaN,8
della,4,0,8,added,8,0,della/templates/about.html,medium,1
della,4,0,4,modified,2,2,della/templates/navbar.html,medium,1
della,2,3,1,removed,0,1,Procfile,NaN,0
della,2,3,2,modified,0,2,README.md,low,0
della,2,3,29,removed,0,29,app.json,medium,0
della,2,3,39,removed,0,39,della/settings/heroku.py,high,0
della,2,3,12,modified,2,10,della/wsgi.py,high,0
della,2,3,7,modified,1,6,manage.py,high,0
della,2,3,2,modified,0,2,requirements.txt,low,0
della,2,3,1,removed,0,1,runtime.txt,low,0
della,1,1,0,added,0,0,della/static/santa wayne.png,low,0
dell-recovery,65,1,14,modified,14,0,Dell/recovery_backend.py,high,0
dell-recovery,65,1,1,modified,1,0,debian/changelog,NaN,0
dell-recovery,63,4,8,modified,8,0,debian/changelog,NaN,1
dell-recovery,63,4,6,modified,3,3,grub/99_dell_recovery,NaN,1
dell-recovery,63,4,4,modified,4,0,late/scripts/wodim-iso.py,high,1
dell-recovery,63,4,31,modified,29,2,ubiquity/dell-bootstrap.py,high,1
dell-recovery,62,3,24,modified,24,0,Dell/recovery_common.py,high,2
dell-recovery,62,3,36,modified,32,4,ubiquity/dell-bootstrap.py,high,2
dell-recovery,61,1,1,modified,1,0,debian/changelog,NaN,1
dell-recovery,61,1,9,modified,8,1,late/scripts/pool.sh,high,0
dell-recovery,60,1,2,modified,1,1,late/scripts/chroot.sh,high,0
dell-recovery,59,2,8,modified,8,0,debian/changelog,NaN,1
dell-recovery,59,2,6,modified,3,3,grub/99_dell_recovery,NaN,1
dell-recovery,59,2,4,modified,4,0,late/scripts/wodim-iso.py,high,1
dell-recovery,58,1,13,modified,7,6,Dell/recovery_common.py,high,2
dell-recovery,58,1,4,modified,2,2,ubiquity/dell-bootstrap.py,high,2
dell-recovery,56,2,2,modified,1,1,Dell/recovery_basic_gtk.py,high,0
dell-recovery,56,2,12,modified,12,0,backend/com.dell.recoverymedia.policy.in,medium,0
dell-recovery,56,2,7,modified,7,0,debian/changelog,NaN,1
dell-recovery,56,2,5,modified,5,0,ubiquity/dell-bootstrap.py,high,2
dell-recovery,55,1,6,modified,6,0,debian/changelog,NaN,1
dell-recovery,55,1,3,modified,2,1,debian/control,NaN,0
dell-recovery,54,2,14,modified,8,6,casper/scripts/99dell_bootstrap,NaN,0
dell-recovery,54,2,3,modified,2,1,late/scripts/pool.sh,high,0
